//MAP CONVERTED BY dmm2tgm.py THIS HEADER COMMENT PREVENTS RECONVERSION, DO NOT REMOVE
"a" = (
/turf/template_noop,
/area/redgate/structure/powered)
"M" = (
/mob/living/simple_mob/vore/scarybot,
/turf/template_noop,
/area/redgate/structure/powered)

(1,1,1) = {"
a
a
a
a
a
"}
(2,1,1) = {"
a
a
a
a
a
"}
(3,1,1) = {"
a
a
M
a
a
"}
(4,1,1) = {"
a
a
a
a
a
"}
(5,1,1) = {"
a
a
a
a
a
"}
