//MAP CONVERTED BY dmm2tgm.py THIS HEADER COMMENT PREVENTS RECONVERSION, DO NOT REMOVE
"c" = (
/obj/random/mob/semirandom_mob_spawner/scarybot,
/turf/template_noop,
/area/redgate/structure/powered)
"g" = (
/turf/template_noop,
/area/redgate/structure/powered)
"h" = (
/turf/simulated/wall/r_wall,
/area/redgate/structure/powered)

(1,1,1) = {"
g
g
g
g
g
"}
(2,1,1) = {"
g
h
h
h
g
"}
(3,1,1) = {"
g
g
c
g
g
"}
(4,1,1) = {"
g
h
h
h
g
"}
(5,1,1) = {"
g
g
g
g
g
"}
