//MAP CONVERTED BY dmm2tgm.py THIS HEADER COMMENT PREVENTS RECONVERSION, DO NOT REMOVE
"g" = (
/turf/template_noop,
/area/redgate/structure/powered)
"v" = (
/obj/random/mob/semirandom_mob_spawner/scarybot,
/turf/simulated/floor/outdoors/grass/heavy,
/area/redgate/structure/powered)
"D" = (
/obj/structure/flora/tree/jungle,
/turf/simulated/floor/outdoors/grass/heavy,
/area/redgate/structure/powered)
"E" = (
/turf/simulated/floor/outdoors/grass/heavy,
/area/redgate/structure/powered)

(1,1,1) = {"
g
g
g
g
g
"}
(2,1,1) = {"
g
g
E
g
g
"}
(3,1,1) = {"
g
E
D
v
g
"}
(4,1,1) = {"
g
g
E
g
g
"}
(5,1,1) = {"
g
g
g
g
g
"}
