//MAP CONVERTED BY dmm2tgm.py THIS HEADER COMMENT PREVENTS RECONVERSION, DO NOT REMOVE
"g" = (
/turf/template_noop,
/area/redgate/structure/powered)

(1,1,1) = {"
g
g
g
g
g
"}
(2,1,1) = {"
g
g
g
g
g
"}
(3,1,1) = {"
g
g
g
g
g
"}
(4,1,1) = {"
g
g
g
g
g
"}
(5,1,1) = {"
g
g
g
g
g
"}
