//MAP CONVERTED BY dmm2tgm.py THIS HEADER COMMENT PREVENTS RECONVERSION, DO NOT REMOVE
"a" = (
/turf/simulated/floor/plating/external/outdoors,
/area/submap/moonbase/poi/west_crater/construction5)
"b" = (
/obj/structure/table/steel,
/obj/random/maintenance,
/turf/simulated/floor/plating/external/outdoors,
/area/submap/moonbase/poi/west_crater/construction5)
"c" = (
/obj/structure/table/rack,
/obj/random/maintenance,
/obj/random/maintenance,
/turf/simulated/floor/plating/external/outdoors,
/area/submap/moonbase/poi/west_crater/construction5)
"g" = (
/obj/structure/table/steel,
/turf/simulated/floor/plating/external/outdoors,
/area/submap/moonbase/poi/west_crater/construction5)
"j" = (
/obj/structure/girder,
/turf/simulated/floor/plating/external/outdoors,
/area/submap/moonbase/poi/west_crater/construction5)
"x" = (
/turf/simulated/wall,
/area/submap/moonbase/poi/west_crater/construction5)
"y" = (
/turf/simulated/mineral/floor/vacuum/moonbase/outdoors,
/area/submap/moonbase/poi/west_crater/construction5)
"L" = (
/turf/simulated/floor/plating/external/moonbaseplating/outdoors{
	edge_blending_priority = 1
	},
/area/submap/moonbase/poi/west_crater/construction5)
"V" = (
/obj/structure/frame,
/turf/simulated/floor/plating/external/outdoors,
/area/submap/moonbase/poi/west_crater/construction5)

(1,1,1) = {"
y
y
y
y
y
y
y
y
y
y
y
y
y
y
y
y
y
y
y
y
y
y
y
y
"}
(2,1,1) = {"
y
y
y
y
y
y
y
y
y
y
y
y
y
y
y
y
y
y
y
y
y
y
y
y
"}
(3,1,1) = {"
y
y
x
x
j
j
x
x
x
y
y
y
y
y
y
L
y
y
y
y
y
y
y
y
"}
(4,1,1) = {"
y
y
x
c
c
a
a
a
x
y
y
y
y
y
y
y
L
y
y
y
y
y
y
y
"}
(5,1,1) = {"
y
y
x
a
a
a
a
a
j
y
y
y
y
y
y
L
L
y
y
y
y
y
y
y
"}
(6,1,1) = {"
y
y
x
a
a
a
a
a
j
y
y
y
y
y
y
L
L
y
y
y
y
y
y
y
"}
(7,1,1) = {"
y
y
x
a
a
a
a
a
a
L
L
L
L
L
L
L
L
L
L
L
L
L
y
y
"}
(8,1,1) = {"
y
y
j
a
a
a
a
a
a
L
L
L
L
L
L
L
L
L
L
L
y
y
y
y
"}
(9,1,1) = {"
y
y
j
a
a
a
a
a
a
y
y
y
y
y
y
L
L
y
y
y
y
y
y
y
"}
(10,1,1) = {"
y
y
j
V
a
a
a
a
j
y
y
y
y
y
y
L
L
y
y
y
y
y
y
y
"}
(11,1,1) = {"
y
y
j
a
a
a
a
a
x
y
y
y
x
x
x
a
a
x
x
x
x
y
y
y
"}
(12,1,1) = {"
y
y
j
V
a
a
a
a
x
y
y
y
x
a
a
a
a
a
a
c
x
y
y
y
"}
(13,1,1) = {"
y
y
j
j
j
x
x
x
x
y
y
y
j
a
a
a
a
a
a
c
x
y
y
y
"}
(14,1,1) = {"
y
y
y
y
y
y
y
y
y
y
y
y
j
a
a
a
a
a
a
a
x
y
y
y
"}
(15,1,1) = {"
y
y
y
y
y
y
y
y
y
y
y
y
j
a
a
b
b
g
a
a
x
y
y
y
"}
(16,1,1) = {"
y
y
y
y
y
y
y
y
y
y
y
y
x
x
x
j
j
j
j
x
x
y
y
y
"}
(17,1,1) = {"
y
y
y
y
y
y
y
y
y
y
y
y
y
y
y
y
y
y
y
y
y
y
y
y
"}
(18,1,1) = {"
y
y
y
y
y
y
y
y
y
y
y
y
y
y
y
y
y
y
y
y
y
y
y
y
"}
