//MAP CONVERTED BY dmm2tgm.py THIS HEADER COMMENT PREVENTS RECONVERSION, DO NOT REMOVE
"a" = (
/turf/template_noop,
/area/template_noop)
"b" = (
/turf/template_noop,
/area/submap/glacier/lake)
"c" = (
/turf/simulated/mineral/crystal_shiny/snowbase/ignore_mapgen,
/area/submap/glacier/lake)
"e" = (
/obj/effect/decal/cleanable/cobweb2,
/turf/simulated/mineral/floor/icey/snowbase/ignore_mapgen,
/area/submap/glacier/lake)
"f" = (
/turf/simulated/mineral/floor/icey/snowbase/ignore_mapgen,
/area/submap/glacier/lake)
"g" = (
/mob/living/simple_mob/animal/sif/hooligan_crab,
/turf/simulated/mineral/floor/icey/snowbase/ignore_mapgen,
/area/submap/glacier/lake)
"j" = (
/obj/machinery/crystal/ice,
/turf/simulated/mineral/floor/icey/snowbase/ignore_mapgen,
/area/submap/glacier/lake)
"k" = (
/turf/simulated/floor/outdoors/ice/snowbase,
/area/submap/glacier/lake)
"l" = (
/obj/effect/decal/cleanable/cobweb,
/turf/simulated/mineral/floor/icey/snowbase/ignore_mapgen,
/area/submap/glacier/lake)
"m" = (
/obj/random/mob/sif,
/turf/simulated/mineral/floor/icey/snowbase/ignore_mapgen,
/area/submap/glacier/lake)
"n" = (
/obj/item/clothing/mask/snorkel,
/turf/simulated/mineral/floor/icey/snowbase/ignore_mapgen,
/area/submap/glacier/lake)
"o" = (
/obj/effect/decal/remains/mouse,
/turf/simulated/mineral/floor/icey/snowbase/ignore_mapgen,
/area/submap/glacier/lake)

(1,1,1) = {"
a
a
a
a
a
a
a
a
a
a
a
a
a
a
a
a
a
a
a
a
a
a
a
a
a
a
a
a
a
a
a
a
a
a
a
a
a
a
a
a
"}
(2,1,1) = {"
a
b
b
b
b
b
c
c
c
c
c
c
c
c
c
c
c
c
c
c
c
c
c
c
c
c
c
c
c
c
c
c
c
b
b
b
b
b
b
a
"}
(3,1,1) = {"
a
b
b
b
c
c
c
c
c
c
c
c
f
f
f
f
f
c
c
c
c
f
f
f
f
f
f
f
f
f
f
f
c
c
b
b
b
b
b
a
"}
(4,1,1) = {"
a
b
b
c
c
c
c
c
c
c
f
f
f
f
f
f
f
f
f
f
f
f
f
f
k
f
f
f
f
f
f
f
f
c
c
b
b
b
b
a
"}
(5,1,1) = {"
a
b
c
c
c
c
f
f
f
f
f
f
f
f
f
f
f
f
f
f
f
f
f
f
k
k
f
f
f
g
f
f
f
f
c
b
b
b
b
a
"}
(6,1,1) = {"
a
c
c
c
f
f
f
f
f
f
f
f
f
f
c
c
j
f
f
f
f
f
f
f
k
k
k
f
f
f
o
f
f
f
c
c
b
b
b
a
"}
(7,1,1) = {"
a
c
c
f
f
f
f
f
f
f
f
f
f
c
c
c
c
f
f
f
f
f
f
f
k
k
k
k
f
f
f
f
f
f
f
c
b
b
b
a
"}
(8,1,1) = {"
a
b
f
f
f
f
f
f
f
f
f
f
f
c
c
c
c
c
f
f
f
f
f
k
k
k
k
k
f
f
f
f
f
f
f
c
b
b
b
a
"}
(9,1,1) = {"
a
b
f
f
f
f
f
f
f
f
f
f
f
c
c
c
c
c
f
f
f
f
f
k
k
k
k
k
k
f
f
f
f
f
f
c
c
b
b
a
"}
(10,1,1) = {"
a
b
f
f
f
f
f
f
f
f
f
f
f
j
c
c
c
l
f
f
f
f
f
k
k
k
k
k
k
f
f
f
f
f
f
c
c
b
b
a
"}
(11,1,1) = {"
a
b
f
f
f
f
f
f
f
f
f
f
f
f
f
c
c
m
f
f
f
n
f
k
k
k
k
k
k
f
f
f
f
f
c
c
c
b
b
a
"}
(12,1,1) = {"
a
b
f
f
f
f
f
f
f
f
f
f
f
f
f
f
f
f
f
f
f
f
f
k
k
k
k
k
k
f
f
f
f
f
c
c
c
b
b
a
"}
(13,1,1) = {"
a
b
c
f
f
f
f
f
f
f
f
f
f
f
f
f
f
f
f
f
f
f
f
k
k
k
k
k
k
k
f
f
f
f
c
c
c
b
b
a
"}
(14,1,1) = {"
a
c
c
f
f
f
f
f
f
f
f
f
f
f
f
f
f
f
f
f
f
f
f
k
k
k
k
k
k
k
f
f
f
f
c
c
c
b
b
a
"}
(15,1,1) = {"
a
c
c
f
f
f
f
f
f
f
f
f
f
f
f
f
f
f
f
f
f
f
f
k
k
k
k
k
k
k
f
f
f
f
f
f
c
b
b
a
"}
(16,1,1) = {"
a
c
c
f
f
f
f
f
f
f
f
f
f
f
f
f
f
f
f
f
f
f
f
k
k
k
k
k
k
k
f
f
f
f
f
f
c
b
b
a
"}
(17,1,1) = {"
a
c
c
f
f
f
f
f
f
f
f
f
f
f
f
f
f
f
f
f
f
f
f
f
k
k
k
k
k
k
f
f
f
f
f
f
c
b
b
a
"}
(18,1,1) = {"
a
c
c
f
f
f
f
f
g
f
f
f
f
f
f
f
f
f
f
f
f
f
f
f
f
f
f
f
k
k
f
f
f
f
f
f
c
b
b
a
"}
(19,1,1) = {"
a
c
c
f
f
f
f
f
f
f
f
f
f
f
f
f
f
f
f
f
f
f
f
f
f
f
f
f
f
k
f
f
f
f
f
c
c
b
b
a
"}
(20,1,1) = {"
a
c
c
f
f
f
f
f
f
f
k
k
f
f
f
f
f
f
f
f
f
f
f
f
f
f
f
f
f
f
f
f
f
f
f
c
b
b
b
a
"}
(21,1,1) = {"
a
b
b
b
f
f
f
f
f
k
k
k
k
k
f
f
f
f
f
f
f
f
f
f
f
f
f
f
f
f
f
f
f
f
f
c
b
b
b
a
"}
(22,1,1) = {"
a
b
b
b
f
f
f
f
f
k
k
k
k
k
k
k
k
k
k
k
f
f
f
f
f
f
f
f
f
f
f
f
f
f
f
c
b
b
b
a
"}
(23,1,1) = {"
a
b
b
b
f
f
f
f
k
k
k
k
k
k
k
k
k
k
k
k
k
k
f
k
k
k
f
f
f
f
f
f
f
f
f
c
b
b
b
a
"}
(24,1,1) = {"
a
b
b
b
f
f
f
f
k
k
k
k
k
k
k
k
k
k
k
k
k
k
k
k
k
k
k
k
f
f
f
f
f
f
f
c
b
b
b
a
"}
(25,1,1) = {"
a
b
b
b
f
f
f
f
k
k
k
k
k
k
k
k
k
k
k
k
k
k
k
k
k
k
k
k
f
f
f
f
f
f
f
c
c
b
b
a
"}
(26,1,1) = {"
a
b
c
b
f
f
f
f
k
k
k
k
k
k
k
k
k
k
k
k
k
k
k
k
k
k
k
k
f
f
f
f
f
f
f
c
c
b
b
a
"}
(27,1,1) = {"
a
b
c
b
f
f
f
f
k
k
k
k
k
k
k
k
k
k
k
k
k
k
k
k
k
k
k
k
f
f
f
f
f
f
c
c
b
b
b
a
"}
(28,1,1) = {"
a
b
c
c
f
f
f
f
k
k
k
k
k
k
k
k
k
k
k
k
k
k
k
k
k
k
k
k
f
f
f
f
f
f
c
c
b
b
b
a
"}
(29,1,1) = {"
a
b
c
c
f
f
f
f
k
k
k
k
k
k
k
k
k
k
k
k
k
k
k
k
k
k
k
k
f
f
f
f
f
f
c
c
b
b
b
a
"}
(30,1,1) = {"
a
b
c
c
f
f
f
f
k
k
k
k
k
k
k
k
k
k
k
k
k
k
k
k
k
k
k
k
f
f
f
f
f
f
b
b
b
b
b
a
"}
(31,1,1) = {"
a
b
c
c
f
f
f
f
f
k
k
k
k
k
k
k
k
k
k
k
k
k
k
k
k
k
k
f
f
f
f
f
f
f
b
b
b
b
b
a
"}
(32,1,1) = {"
a
b
c
c
f
f
f
f
f
f
f
k
k
k
k
k
k
k
k
k
k
k
k
k
k
k
k
f
f
f
f
f
f
f
b
b
b
b
b
a
"}
(33,1,1) = {"
a
b
c
c
f
f
f
f
f
f
f
f
k
k
k
k
k
k
k
k
k
k
k
k
k
f
f
f
f
f
f
f
f
f
f
b
b
b
b
a
"}
(34,1,1) = {"
a
b
c
c
f
f
f
f
f
f
f
f
f
k
k
k
k
k
k
k
k
k
k
k
k
f
f
f
f
f
f
f
f
f
f
b
b
b
b
a
"}
(35,1,1) = {"
a
b
c
c
e
f
f
f
f
f
f
f
f
k
k
k
k
k
k
k
k
k
k
k
f
f
f
f
f
f
f
f
f
f
f
c
b
b
b
a
"}
(36,1,1) = {"
a
b
c
c
c
c
f
f
f
f
f
f
f
k
k
k
k
k
k
k
k
k
k
k
f
f
f
f
c
c
c
c
c
c
c
b
b
b
b
a
"}
(37,1,1) = {"
a
b
b
c
c
c
c
c
c
c
c
c
f
k
k
k
k
k
k
k
k
k
k
f
c
c
c
c
c
c
c
c
c
b
b
b
b
b
b
a
"}
(38,1,1) = {"
a
b
b
b
b
b
b
b
b
b
c
c
f
f
f
f
f
f
f
f
f
f
f
f
c
c
b
c
c
c
c
b
b
b
b
b
b
b
b
a
"}
(39,1,1) = {"
a
b
b
b
b
b
b
b
b
b
b
c
c
c
c
c
c
c
c
c
c
c
c
c
c
b
b
b
b
b
b
b
b
b
b
b
b
b
b
a
"}
(40,1,1) = {"
a
a
a
a
a
a
a
a
a
a
a
a
a
a
a
a
a
a
a
a
a
a
a
a
a
a
a
a
a
a
a
a
a
a
a
a
a
a
a
a
"}
