//MAP CONVERTED BY dmm2tgm.py THIS HEADER COMMENT PREVENTS RECONVERSION, DO NOT REMOVE
"b" = (
/turf/simulated/mineral/floor/icey/snowbase/ignore_mapgen,
/area/submap/glacier/spatial_anomaly)
"c" = (
/obj/effect/map_effect/portal/master/side_a{
	dir = 4;
	icon_state = "portal_side_a";
	portal_id = "spatial_anomaly_5"
	},
/obj/effect/map_effect/perma_light/brighter{
	light_color = "#ff00ff"
	},
/turf/simulated/mineral/floor/icey/snowbase/ignore_mapgen,
/area/submap/glacier/spatial_anomaly)
"d" = (
/obj/effect/map_effect/portal/master/side_b{
	dir = 8;
	icon_state = "portal_side_b";
	portal_id = "spatial_anomaly_5"
	},
/obj/effect/map_effect/perma_light/brighter{
	light_color = "#ff00ff"
	},
/turf/simulated/mineral/floor/icey/snowbase/ignore_mapgen,
/area/submap/glacier/spatial_anomaly)
"e" = (
/obj/structure/barricade,
/turf/simulated/mineral/floor/icey/snowbase/ignore_mapgen,
/area/submap/glacier/spatial_anomaly)
"f" = (
/turf/template_noop,
/area/template_noop)
"g" = (
/obj/effect/map_effect/portal/master/side_b{
	portal_id = "spatial_anomaly_4"
	},
/obj/effect/map_effect/perma_light/brighter{
	light_color = "#ff00ff"
	},
/turf/simulated/mineral/floor/icey/snowbase/ignore_mapgen,
/area/submap/glacier/spatial_anomaly)
"h" = (
/obj/effect/map_effect/portal/line/side_a{
	dir = 4;
	icon_state = "portal_line_side_a"
	},
/obj/effect/map_effect/perma_light/brighter{
	light_color = "#ff00ff"
	},
/turf/simulated/mineral/floor/icey/snowbase/ignore_mapgen,
/area/submap/glacier/spatial_anomaly)
"i" = (
/obj/effect/map_effect/portal/line/side_b{
	dir = 8;
	icon_state = "portal_line_side_b"
	},
/obj/effect/map_effect/perma_light/brighter{
	light_color = "#ff00ff"
	},
/turf/simulated/mineral/floor/icey/snowbase/ignore_mapgen,
/area/submap/glacier/spatial_anomaly)
"j" = (
/turf/simulated/floor/lava,
/area/submap/glacier/spatial_anomaly)
"k" = (
/obj/item/weapon/disposable_teleporter/slime,
/turf/simulated/mineral/floor/icey/snowbase/ignore_mapgen,
/area/submap/glacier/spatial_anomaly)
"l" = (
/obj/effect/map_effect/perma_light/brighter{
	light_color = "#ff00ff"
	},
/turf/simulated/mineral/floor/icey/snowbase/ignore_mapgen,
/area/submap/glacier/spatial_anomaly)
"m" = (
/obj/effect/map_effect/perma_light/brighter{
	light_color = "#ff00ff"
	},
/turf/simulated/floor/plating/external,
/area/submap/glacier/spatial_anomaly)
"n" = (
/obj/effect/map_effect/portal/master/side_a{
	dir = 4;
	icon_state = "portal_side_a";
	portal_id = "spatial_anomaly_3"
	},
/obj/effect/map_effect/perma_light/brighter{
	light_color = "#ff00ff"
	},
/turf/simulated/mineral/floor/icey/snowbase/ignore_mapgen,
/area/submap/glacier/spatial_anomaly)
"o" = (
/obj/effect/map_effect/portal/master/side_a{
	dir = 1;
	icon_state = "portal_side_a";
	portal_id = "spatial_anomaly_4"
	},
/obj/effect/map_effect/perma_light/brighter{
	light_color = "#ff00ff"
	},
/turf/simulated/mineral/floor/icey/snowbase/ignore_mapgen,
/area/submap/glacier/spatial_anomaly)
"p" = (
/obj/effect/map_effect/portal/master/side_b{
	dir = 8;
	icon_state = "portal_side_b";
	portal_id = "spatial_anomaly_3"
	},
/obj/effect/map_effect/perma_light/brighter{
	light_color = "#ff00ff"
	},
/turf/simulated/mineral/floor/icey/snowbase/ignore_mapgen,
/area/submap/glacier/spatial_anomaly)
"q" = (
/obj/effect/map_effect/portal/master/side_b{
	portal_id = "spatial_anomaly_2"
	},
/obj/effect/map_effect/perma_light/brighter{
	light_color = "#ff00ff"
	},
/turf/simulated/mineral/floor/icey/snowbase/ignore_mapgen,
/area/submap/glacier/spatial_anomaly)
"r" = (
/obj/effect/map_effect/portal/line/side_b,
/obj/effect/map_effect/perma_light/brighter{
	light_color = "#ff00ff"
	},
/turf/simulated/mineral/floor/icey/snowbase/ignore_mapgen,
/area/submap/glacier/spatial_anomaly)
"s" = (
/obj/machinery/crystal/lava,
/turf/simulated/floor/lava,
/area/submap/glacier/spatial_anomaly)
"t" = (
/turf/simulated/floor/plating/external,
/area/submap/glacier/spatial_anomaly)
"u" = (
/obj/effect/map_effect/portal/master/side_a{
	portal_id = "spatial_anomaly_1"
	},
/obj/effect/map_effect/perma_light/brighter{
	light_color = "#ff00ff"
	},
/turf/simulated/mineral/floor/icey/snowbase/ignore_mapgen,
/area/submap/glacier/spatial_anomaly)
"v" = (
/obj/item/weapon/stool/padded,
/turf/simulated/floor/plating/external,
/area/submap/glacier/spatial_anomaly)
"w" = (
/obj/structure/table/steel_reinforced,
/obj/item/device/xenoarch_multi_tool,
/turf/simulated/floor/plating/external,
/area/submap/glacier/spatial_anomaly)
"x" = (
/turf/simulated/wall/solidrock,
/area/submap/glacier/spatial_anomaly)
"y" = (
/obj/random/technology_scanner,
/turf/simulated/mineral/floor/icey/snowbase/ignore_mapgen,
/area/submap/glacier/spatial_anomaly)
"z" = (
/obj/structure/table/steel_reinforced,
/obj/random/unidentified_medicine/scientific,
/turf/simulated/floor/plating/external,
/area/submap/glacier/spatial_anomaly)
"A" = (
/obj/structure/table/steel_reinforced,
/obj/random/tool/power,
/turf/simulated/floor/plating/external,
/area/submap/glacier/spatial_anomaly)
"B" = (
/obj/structure/table/steel_reinforced,
/obj/item/weapon/ore/diamond,
/turf/simulated/floor/plating/external,
/area/submap/glacier/spatial_anomaly)
"C" = (
/obj/structure/sign/warning/lava,
/turf/simulated/wall,
/area/submap/glacier/spatial_anomaly)
"D" = (
/obj/effect/map_effect/portal/line/side_a,
/obj/effect/map_effect/perma_light/brighter{
	light_color = "#ff00ff"
	},
/turf/simulated/mineral/floor/icey/snowbase/ignore_mapgen,
/area/submap/glacier/spatial_anomaly)
"E" = (
/obj/structure/table/rack,
/obj/item/weapon/pickaxe/jackhammer,
/turf/simulated/mineral/floor/icey/snowbase/ignore_mapgen,
/area/submap/glacier/spatial_anomaly)
"F" = (
/obj/effect/map_effect/portal/master/side_a{
	dir = 1;
	icon_state = "portal_side_a";
	portal_id = "spatial_anomaly_2"
	},
/obj/effect/map_effect/perma_light/brighter{
	light_color = "#ff00ff"
	},
/turf/simulated/mineral/floor/icey/snowbase/ignore_mapgen,
/area/submap/glacier/spatial_anomaly)
"G" = (
/obj/effect/map_effect/portal/line/side_a{
	dir = 1;
	icon_state = "portal_line_side_a"
	},
/obj/effect/map_effect/perma_light/brighter{
	light_color = "#ff00ff"
	},
/turf/simulated/mineral/floor/icey/snowbase/ignore_mapgen,
/area/submap/glacier/spatial_anomaly)
"I" = (
/obj/effect/map_effect/portal/master/side_b{
	dir = 1;
	icon_state = "portal_side_b";
	portal_id = "spatial_anomaly_1"
	},
/obj/effect/map_effect/perma_light/brighter{
	light_color = "#ff00ff"
	},
/turf/simulated/mineral/floor/icey/snowbase/ignore_mapgen,
/area/submap/glacier/spatial_anomaly)
"J" = (
/obj/effect/map_effect/portal/line/side_b{
	dir = 1;
	icon_state = "portal_line_side_b"
	},
/obj/effect/map_effect/perma_light/brighter{
	light_color = "#ff00ff"
	},
/turf/simulated/mineral/floor/icey/snowbase/ignore_mapgen,
/area/submap/glacier/spatial_anomaly)
"K" = (
/obj/item/weapon/mining_scanner,
/obj/structure/table/rack,
/turf/simulated/mineral/floor/icey/snowbase/ignore_mapgen,
/area/submap/glacier/spatial_anomaly)
"L" = (
/obj/item/weapon/storage/belt/archaeology,
/obj/effect/decal/remains/human,
/turf/simulated/mineral/floor/icey/snowbase/ignore_mapgen,
/area/submap/glacier/spatial_anomaly)
"M" = (
/obj/structure/bookcase/manuals/xenoarchaeology,
/turf/simulated/floor/plating/external,
/area/submap/glacier/spatial_anomaly)
"N" = (
/obj/item/weapon/pickaxe/brush,
/turf/simulated/mineral/floor/icey/snowbase/ignore_mapgen,
/area/submap/glacier/spatial_anomaly)
"O" = (
/obj/item/weapon/pickaxe/one_pick,
/turf/simulated/mineral/floor/icey/snowbase/ignore_mapgen,
/area/submap/glacier/spatial_anomaly)
"P" = (
/obj/item/weapon/pickaxe/four_pick,
/turf/simulated/mineral/floor/icey/snowbase/ignore_mapgen,
/area/submap/glacier/spatial_anomaly)
"Q" = (
/obj/effect/decal/remains/human,
/turf/simulated/floor/plating/external,
/area/submap/glacier/spatial_anomaly)
"R" = (
/obj/item/weapon/pickaxe/five_pick,
/turf/simulated/mineral/floor/icey/snowbase/ignore_mapgen,
/area/submap/glacier/spatial_anomaly)
"S" = (
/obj/item/weapon/pickaxe/six_pick,
/turf/simulated/mineral/floor/icey/snowbase/ignore_mapgen,
/area/submap/glacier/spatial_anomaly)
"T" = (
/obj/item/weapon/pickaxe/two_pick,
/turf/simulated/mineral/floor/icey/snowbase/ignore_mapgen,
/area/submap/glacier/spatial_anomaly)
"U" = (
/obj/item/device/measuring_tape,
/turf/simulated/mineral/floor/icey/snowbase/ignore_mapgen,
/area/submap/glacier/spatial_anomaly)
"X" = (
/obj/item/weapon/pickaxe/three_pick,
/turf/simulated/mineral/floor/icey/snowbase/ignore_mapgen,
/area/submap/glacier/spatial_anomaly)
"Y" = (
/obj/item/weapon/pickaxe/excavationdrill,
/turf/simulated/floor/plating/external,
/area/submap/glacier/spatial_anomaly)

(1,1,1) = {"
f
f
f
f
f
f
f
f
f
f
f
f
f
f
f
f
f
f
f
f
f
f
f
f
f
f
f
f
f
f
"}
(2,1,1) = {"
f
f
f
f
f
f
f
f
f
f
f
f
f
f
f
f
f
f
f
f
f
f
f
f
f
f
f
f
f
f
"}
(3,1,1) = {"
f
f
f
f
f
f
f
f
x
x
x
x
x
x
x
x
x
x
f
f
f
f
f
f
f
f
f
f
f
f
"}
(4,1,1) = {"
f
f
f
f
f
x
x
x
x
x
x
x
x
x
x
x
x
x
x
x
f
f
f
f
f
f
f
f
f
f
"}
(5,1,1) = {"
f
f
f
x
x
x
x
x
x
x
x
l
b
b
b
b
b
x
x
x
x
x
x
x
f
f
f
f
f
f
"}
(6,1,1) = {"
f
f
x
x
x
x
x
x
x
x
x
b
x
x
x
x
R
x
x
x
x
x
x
x
x
x
x
f
f
f
"}
(7,1,1) = {"
f
f
x
x
t
g
b
O
b
x
x
b
x
x
x
x
b
x
x
x
b
T
b
I
t
x
x
f
f
f
"}
(8,1,1) = {"
f
f
x
x
x
x
x
b
b
x
x
b
x
x
x
x
p
x
x
l
b
b
b
J
t
x
x
f
f
f
"}
(9,1,1) = {"
f
f
x
x
x
x
x
x
b
x
x
b
x
x
x
x
t
x
x
b
x
b
b
J
t
x
x
f
f
f
"}
(10,1,1) = {"
f
f
x
x
t
t
x
x
l
x
x
b
b
b
o
t
x
x
x
b
x
x
x
x
x
x
f
f
f
f
"}
(11,1,1) = {"
f
f
x
x
c
h
x
x
b
x
x
x
x
x
x
x
x
x
x
b
b
b
b
b
x
x
f
f
f
f
"}
(12,1,1) = {"
f
f
x
x
b
b
x
x
b
b
t
x
x
x
x
x
x
x
x
x
x
X
b
l
x
x
x
f
f
f
"}
(13,1,1) = {"
f
f
x
x
b
b
x
b
b
b
t
t
B
x
x
t
q
b
b
b
b
b
b
b
x
x
x
f
f
f
"}
(14,1,1) = {"
f
x
x
x
b
b
b
b
y
b
t
v
w
x
x
t
r
b
b
b
x
x
x
x
x
x
x
f
f
f
"}
(15,1,1) = {"
f
x
x
x
b
b
C
N
b
t
t
t
z
x
x
t
r
b
b
b
b
b
b
b
x
x
x
f
f
f
"}
(16,1,1) = {"
f
x
x
x
j
b
b
b
b
m
t
Q
A
x
x
x
x
x
x
x
b
b
b
t
x
x
x
f
f
f
"}
(17,1,1) = {"
f
x
x
x
j
j
b
b
x
x
x
x
x
x
x
x
x
x
x
x
b
L
m
t
x
x
x
f
f
f
"}
(18,1,1) = {"
f
x
x
x
j
j
s
x
x
x
x
x
x
x
b
b
b
b
b
b
b
b
t
t
x
x
x
f
f
f
"}
(19,1,1) = {"
f
x
x
x
s
j
x
x
b
b
b
l
b
b
b
b
S
b
l
b
b
Y
t
M
x
x
x
f
f
f
"}
(20,1,1) = {"
f
f
x
x
j
j
x
x
P
b
x
x
x
x
x
x
x
x
x
x
x
x
x
x
x
x
f
f
f
f
"}
(21,1,1) = {"
f
f
x
x
k
b
x
x
b
x
x
x
x
t
x
x
x
x
x
x
x
x
x
x
x
x
f
f
f
f
"}
(22,1,1) = {"
f
f
x
x
b
b
x
x
b
x
x
x
x
n
x
x
t
u
b
b
U
b
F
t
x
x
f
f
f
f
"}
(23,1,1) = {"
f
f
x
x
d
i
x
x
b
x
x
x
x
b
x
x
t
D
b
b
b
b
G
t
x
x
f
f
f
f
"}
(24,1,1) = {"
f
f
x
x
t
t
x
x
l
b
b
b
b
b
x
x
t
D
b
b
b
b
G
t
x
x
f
f
f
f
"}
(25,1,1) = {"
f
f
f
x
x
x
x
x
x
x
x
x
x
x
x
x
x
x
x
b
b
x
x
x
x
f
f
f
f
f
"}
(26,1,1) = {"
f
f
f
f
x
x
x
x
x
x
x
x
x
x
x
x
x
b
e
l
E
x
x
x
f
f
f
f
f
f
"}
(27,1,1) = {"
f
f
f
f
f
f
f
x
x
x
x
x
f
f
f
f
f
l
e
b
K
x
x
f
f
f
f
f
f
f
"}
(28,1,1) = {"
f
f
f
f
f
f
f
f
f
f
f
f
f
f
f
f
f
b
x
x
x
x
f
f
f
f
f
f
f
f
"}
(29,1,1) = {"
f
f
f
f
f
f
f
f
f
f
f
f
f
f
f
f
x
x
x
x
f
f
f
f
f
f
f
f
f
f
"}
(30,1,1) = {"
f
f
f
f
f
f
f
f
f
f
f
f
f
f
f
f
f
f
f
f
f
f
f
f
f
f
f
f
f
f
"}
