//MAP CONVERTED BY dmm2tgm.py THIS HEADER COMMENT PREVENTS RECONVERSION, DO NOT REMOVE
"a" = (
/turf/template_noop,
/area/template_noop)
"b" = (
/obj/structure/cliff/automatic/corner{
	dir = 6;
	icon_state = "cliffbuilder-corner"
	},
/turf/simulated/mineral/floor/icey/snowbase/ignore_mapgen,
/area/submap/glacier/vault6)
"c" = (
/obj/structure/cliff/automatic{
	dir = 2;
	icon_state = "cliffbuilder"
	},
/turf/simulated/mineral/floor/icey/snowbase/ignore_mapgen,
/area/submap/glacier/vault6)
"d" = (
/obj/structure/cliff/automatic/corner{
	dir = 10;
	icon_state = "cliffbuilder-corner"
	},
/turf/simulated/mineral/floor/icey/snowbase/ignore_mapgen,
/area/submap/glacier/vault6)
"e" = (
/obj/structure/cliff/automatic{
	dir = 6;
	icon_state = "cliffbuilder"
	},
/turf/simulated/mineral/floor/icey/snowbase/ignore_mapgen,
/area/submap/glacier/vault6)
"g" = (
/obj/structure/cliff/automatic{
	dir = 10;
	icon_state = "cliffbuilder"
	},
/turf/simulated/mineral/floor/icey/snowbase/ignore_mapgen,
/area/submap/glacier/vault6)
"h" = (
/obj/structure/cliff/automatic{
	dir = 4;
	icon_state = "cliffbuilder"
	},
/turf/simulated/mineral/floor/icey/snowbase/ignore_mapgen,
/area/submap/glacier/vault6)
"i" = (
/mob/living/simple_mob/humanoid/merc/ranged/grenadier,
/turf/simulated/mineral/floor/icey/snowbase/ignore_mapgen,
/area/submap/glacier/vault6)
"j" = (
/turf/simulated/mineral/floor/icey/snowbase/ignore_mapgen,
/area/submap/glacier/vault6)
"k" = (
/obj/random/tool/power,
/obj/random/tech_supply,
/turf/simulated/mineral/floor/icey/snowbase/ignore_mapgen,
/area/submap/glacier/vault6)
"l" = (
/obj/structure/cliff/automatic{
	dir = 8;
	icon_state = "cliffbuilder"
	},
/turf/simulated/mineral/floor/icey/snowbase/ignore_mapgen,
/area/submap/glacier/vault6)
"m" = (
/obj/structure/bonfire/permanent/sifwood,
/obj/structure/grille/rustic,
/turf/simulated/mineral/floor/icey/snowbase/ignore_mapgen,
/area/submap/glacier/vault6)
"n" = (
/obj/random/multiple/minevault,
/turf/simulated/mineral/floor/icey/snowbase/ignore_mapgen,
/area/submap/glacier/vault6)
"o" = (
/obj/structure/cliff/automatic/corner,
/turf/simulated/mineral/floor/icey/snowbase/ignore_mapgen,
/area/submap/glacier/vault6)
"p" = (
/obj/structure/cliff/automatic{
	dir = 5;
	icon_state = "cliffbuilder"
	},
/turf/simulated/mineral/floor/icey/snowbase/ignore_mapgen,
/area/submap/glacier/vault6)
"q" = (
/obj/structure/cliff/automatic{
	dir = 9;
	icon_state = "cliffbuilder"
	},
/turf/simulated/mineral/floor/icey/snowbase/ignore_mapgen,
/area/submap/glacier/vault6)
"r" = (
/obj/structure/cliff/automatic/corner{
	dir = 9;
	icon_state = "cliffbuilder-corner"
	},
/turf/simulated/mineral/floor/icey/snowbase/ignore_mapgen,
/area/submap/glacier/vault6)
"s" = (
/obj/structure/cliff/automatic,
/turf/simulated/mineral/floor/icey/snowbase/ignore_mapgen,
/area/submap/glacier/vault6)

(1,1,1) = {"
a
a
a
a
a
a
a
a
a
"}
(2,1,1) = {"
a
a
b
h
h
h
o
a
a
"}
(3,1,1) = {"
a
b
e
j
j
j
p
o
a
"}
(4,1,1) = {"
a
c
j
i
j
n
j
s
a
"}
(5,1,1) = {"
a
c
j
j
m
j
j
s
a
"}
(6,1,1) = {"
a
c
j
k
j
j
j
s
a
"}
(7,1,1) = {"
a
d
g
j
j
j
q
r
a
"}
(8,1,1) = {"
a
a
d
l
l
l
r
a
a
"}
(9,1,1) = {"
a
a
a
a
a
a
a
a
a
"}
