//MAP CONVERTED BY dmm2tgm.py THIS HEADER COMMENT PREVENTS RECONVERSION, DO NOT REMOVE
"a" = (
/turf/template_noop,
/area/submap/glacier/AbandonedTemple)
"c" = (
/turf/simulated/mineral/floor/icey/snowbase/ignore_mapgen,
/area/submap/glacier/AbandonedTemple)
"e" = (
/obj/effect/decal/cleanable/cobweb,
/turf/simulated/floor/carpet/turcarpet,
/area/submap/glacier/AbandonedTemple)
"f" = (
/obj/effect/decal/remains/mummy1,
/turf/simulated/floor/carpet/turcarpet,
/area/submap/glacier/AbandonedTemple)
"g" = (
/turf/simulated/wall/snowbrick,
/area/submap/glacier/AbandonedTemple)
"h" = (
/obj/item/weapon/flame/candle/everburn,
/turf/simulated/floor/wood/alt,
/area/submap/glacier/AbandonedTemple)
"i" = (
/obj/item/weapon/ectoplasm,
/turf/simulated/floor/wood/alt,
/area/submap/glacier/AbandonedTemple)
"j" = (
/obj/structure/table/wooden_reinforced,
/obj/item/weapon/coin/iron,
/obj/item/weapon/coin/platinum,
/obj/item/weapon/coin/uranium,
/obj/item/weapon/coin/diamond,
/obj/item/weapon/coin/iron,
/obj/item/weapon/coin/uranium,
/obj/item/weapon/coin/iron,
/obj/item/weapon/coin/phoron,
/obj/item/weapon/coin/platinum,
/obj/effect/decal/cleanable/cobweb,
/turf/simulated/floor/wood/alt,
/area/submap/glacier/AbandonedTemple)
"k" = (
/obj/structure/table/wooden_reinforced,
/obj/item/weapon/coin/gold,
/obj/item/weapon/coin/gold,
/obj/item/weapon/coin/gold,
/obj/item/weapon/coin/silver,
/obj/item/weapon/coin/silver,
/obj/item/weapon/coin/silver,
/obj/item/weapon/coin/gold,
/obj/item/weapon/coin/gold,
/obj/item/weapon/coin/gold,
/obj/item/weapon/coin/silver,
/obj/item/weapon/coin/silver,
/obj/item/weapon/coin/silver,
/turf/simulated/floor/wood/alt,
/area/submap/glacier/AbandonedTemple)
"l" = (
/obj/effect/decal/remains/xeno,
/turf/simulated/floor/wood/alt,
/area/submap/glacier/AbandonedTemple)
"m" = (
/obj/effect/decal/cleanable/cobweb2,
/turf/simulated/floor/wood/alt,
/area/submap/glacier/AbandonedTemple)
"n" = (
/obj/structure/loot_pile/maint/technical,
/turf/simulated/floor/wood/alt,
/area/submap/glacier/AbandonedTemple)
"o" = (
/obj/structure/loot_pile/maint/technical,
/obj/effect/decal/cleanable/cobweb2,
/turf/simulated/floor/wood/alt,
/area/submap/glacier/AbandonedTemple)
"p" = (
/turf/simulated/floor/carpet/turcarpet,
/area/submap/glacier/AbandonedTemple)
"q" = (
/obj/structure/table/woodentable,
/obj/item/weapon/flame/lighter/zippo/royal,
/obj/item/clothing/mask/smokable/pipe,
/turf/simulated/floor/carpet/turcarpet,
/area/submap/glacier/AbandonedTemple)
"r" = (
/obj/effect/rune,
/obj/effect/decal/remains/human,
/turf/simulated/floor/wood/alt,
/area/submap/glacier/AbandonedTemple)
"s" = (
/obj/effect/decal/cleanable/blood,
/turf/simulated/floor/wood/alt,
/area/submap/glacier/AbandonedTemple)
"t" = (
/obj/machinery/artifact,
/turf/simulated/floor/wood/alt,
/area/submap/glacier/AbandonedTemple)
"u" = (
/obj/structure/bed/chair/comfy/brown{
	dir = 4
	},
/obj/effect/decal/cleanable/blood,
/turf/simulated/floor/carpet/turcarpet,
/area/submap/glacier/AbandonedTemple)
"v" = (
/obj/structure/table/woodentable,
/obj/item/weapon/paper,
/obj/item/weapon/pen/fountain,
/turf/simulated/floor/carpet/turcarpet,
/area/submap/glacier/AbandonedTemple)
"w" = (
/obj/effect/decal/cleanable/blood/xeno,
/turf/simulated/floor/wood/alt,
/area/submap/glacier/AbandonedTemple)
"x" = (
/obj/effect/decal/cleanable/blood/xeno,
/obj/effect/decal/remains/posi,
/turf/simulated/floor/wood/alt,
/area/submap/glacier/AbandonedTemple)
"y" = (
/obj/structure/table/woodentable,
/obj/item/weapon/flame/candle/candelabra/everburn,
/turf/simulated/floor/carpet/turcarpet,
/area/submap/glacier/AbandonedTemple)
"z" = (
/obj/structure/simple_door/gold,
/turf/simulated/floor/wood/alt,
/area/submap/glacier/AbandonedTemple)
"A" = (
/obj/effect/decal/remains/posi,
/turf/simulated/floor/wood/alt,
/area/submap/glacier/AbandonedTemple)
"B" = (
/obj/machinery/crystal{
	icon_state = "crystal3";
	light_color = "#f44256";
	light_power = 3
	},
/obj/effect/decal/cleanable/cobweb,
/turf/simulated/floor/wood/alt,
/area/submap/glacier/AbandonedTemple)
"C" = (
/obj/structure/flora/pottedplant/dead,
/turf/simulated/floor/wood/alt,
/area/submap/glacier/AbandonedTemple)
"D" = (
/obj/machinery/crystal{
	icon_state = "crystal3";
	light_color = "#f44256";
	light_power = 3
	},
/turf/simulated/floor/wood/alt,
/area/submap/glacier/AbandonedTemple)
"E" = (
/obj/effect/decal/remains/human,
/turf/simulated/floor/wood/alt,
/area/submap/glacier/AbandonedTemple)
"F" = (
/obj/effect/decal/cleanable/blood,
/obj/effect/decal/remains/human,
/turf/simulated/floor/carpet/turcarpet,
/area/submap/glacier/AbandonedTemple)
"G" = (
/obj/structure/table/woodentable,
/obj/item/weapon/paper/alien{
	desc = "";
	icon_state = "alienpaper_words";
	info = "(On the screen of the tablet are several lines of characters written in a language you don't seem to recognize. At the end of each line is a set of numbers seperated by a colon. The screen flickers occasionally, as if damaged. Nothing about the tablet seems particularly interesting, but it does seem very, very old.)"
	},
/turf/simulated/floor/carpet/turcarpet,
/area/submap/glacier/AbandonedTemple)
"H" = (
/obj/effect/decal/cleanable/blood/xeno,
/turf/simulated/floor/carpet/turcarpet,
/area/submap/glacier/AbandonedTemple)
"I" = (
/obj/structure/table/bench/wooden,
/turf/simulated/floor/wood/alt,
/area/submap/glacier/AbandonedTemple)
"J" = (
/obj/effect/decal/cleanable/cobweb,
/turf/simulated/mineral/floor/icey/snowbase/ignore_mapgen,
/area/submap/glacier/AbandonedTemple)
"K" = (
/obj/structure/table/bench/wooden,
/obj/effect/decal/remains/xeno,
/turf/simulated/floor/wood/alt,
/area/submap/glacier/AbandonedTemple)
"L" = (
/obj/structure/simple_door/sandstone,
/turf/simulated/floor/wood/alt,
/area/submap/glacier/AbandonedTemple)
"M" = (
/obj/effect/decal/cleanable/cobweb,
/obj/item/weapon/flame/candle/candelabra/everburn,
/turf/simulated/floor/wood/alt,
/area/submap/glacier/AbandonedTemple)
"N" = (
/obj/effect/decal/cleanable/cobweb2,
/obj/item/weapon/flame/candle/candelabra/everburn,
/turf/simulated/floor/wood/alt,
/area/submap/glacier/AbandonedTemple)
"O" = (
/obj/effect/decal/cleanable/blood,
/turf/simulated/mineral/floor/icey/snowbase/ignore_mapgen,
/area/submap/glacier/AbandonedTemple)
"Q" = (
/turf/simulated/floor/wood/alt,
/area/submap/glacier/AbandonedTemple)
"R" = (
/obj/effect/decal/cleanable/cobweb2,
/turf/simulated/mineral/floor/icey/snowbase/ignore_mapgen,
/area/submap/glacier/AbandonedTemple)

(1,1,1) = {"
a
a
a
a
a
a
a
a
a
a
a
a
a
a
a
a
a
a
a
a
a
a
a
a
a
"}
(2,1,1) = {"
a
a
a
c
c
c
c
c
c
c
c
c
c
c
c
c
c
c
c
c
a
a
a
a
a
"}
(3,1,1) = {"
a
a
c
c
c
c
c
c
c
c
c
c
c
c
c
c
c
c
c
c
c
a
a
a
a
"}
(4,1,1) = {"
a
c
c
g
g
g
g
g
g
g
g
g
g
g
R
c
c
c
c
c
c
c
a
a
a
"}
(5,1,1) = {"
a
c
c
g
e
p
u
p
p
p
w
Q
Q
g
g
R
c
c
c
c
c
c
c
a
a
"}
(6,1,1) = {"
a
c
c
g
f
q
v
y
p
p
Q
E
Q
s
g
g
c
c
c
c
c
c
c
a
a
"}
(7,1,1) = {"
a
c
c
g
g
g
g
g
g
g
g
g
z
g
g
g
g
c
c
c
c
c
c
a
a
"}
(8,1,1) = {"
a
c
c
g
h
Q
h
z
Q
g
B
Q
Q
Q
Q
Q
g
g
c
c
c
c
c
a
a
"}
(9,1,1) = {"
a
c
c
g
i
r
Q
g
Q
g
C
Q
Q
Q
Q
Q
D
g
R
c
c
O
c
a
a
"}
(10,1,1) = {"
a
c
c
g
h
s
h
g
Q
g
Q
w
Q
I
Q
K
Q
g
g
g
g
c
c
a
a
"}
(11,1,1) = {"
a
c
c
g
g
g
g
g
Q
z
Q
p
p
I
Q
I
Q
g
M
Q
g
c
c
a
a
"}
(12,1,1) = {"
a
c
c
g
j
Q
p
p
Q
g
Q
F
G
Q
Q
Q
w
L
Q
w
L
c
c
a
a
"}
(13,1,1) = {"
a
c
c
g
k
Q
p
p
Q
g
Q
p
y
Q
Q
Q
s
L
Q
Q
L
c
O
a
a
"}
(14,1,1) = {"
a
c
c
g
g
g
g
g
Q
z
Q
p
H
I
Q
I
Q
g
N
Q
g
O
c
a
a
"}
(15,1,1) = {"
a
c
c
g
Q
Q
w
g
Q
g
Q
Q
l
I
Q
I
Q
g
g
g
g
c
c
a
a
"}
(16,1,1) = {"
a
c
c
g
l
t
Q
g
Q
g
C
Q
Q
Q
Q
Q
D
g
O
c
c
c
c
a
a
"}
(17,1,1) = {"
a
c
c
g
m
Q
Q
z
Q
g
D
Q
Q
Q
Q
s
g
g
c
c
c
c
c
a
a
"}
(18,1,1) = {"
a
c
c
g
g
g
g
g
g
g
g
g
z
g
g
g
g
J
c
c
c
c
c
a
a
"}
(19,1,1) = {"
a
c
c
g
n
Q
Q
n
Q
Q
Q
Q
w
n
g
g
c
c
c
c
c
c
c
a
a
"}
(20,1,1) = {"
a
c
c
g
o
Q
x
Q
Q
A
n
l
n
g
g
c
c
c
c
c
c
c
c
a
a
"}
(21,1,1) = {"
a
c
c
g
g
g
g
g
g
g
g
g
g
g
J
c
c
c
c
c
c
c
a
a
a
"}
(22,1,1) = {"
a
a
c
c
c
c
c
c
c
c
c
c
c
c
c
c
c
c
c
c
c
a
a
a
a
"}
(23,1,1) = {"
a
a
a
c
c
c
c
c
c
c
c
c
c
c
c
c
c
c
c
c
a
a
a
a
a
"}
(24,1,1) = {"
a
a
a
a
a
a
a
a
a
a
a
a
a
a
a
a
a
a
a
a
a
a
a
a
a
"}
(25,1,1) = {"
a
a
a
a
a
a
a
a
a
a
a
a
a
a
a
a
a
a
a
a
a
a
a
a
a
"}
