//MAP CONVERTED BY dmm2tgm.py THIS HEADER COMMENT PREVENTS RECONVERSION, DO NOT REMOVE
"a" = (
/turf/simulated/mineral/crystal_shiny/snowbase/ignore_mapgen,
/area/template_noop)
"b" = (
/turf/simulated/mineral/floor/icey/snowbase/ignore_mapgen,
/area/template_noop)
"d" = (
/obj/structure/cliff/automatic{
	dir = 9;
	icon_state = "cliffbuilder"
	},
/turf/simulated/mineral/floor/icey/snowbase/ignore_mapgen,
/area/submap/glacier/Excavation)
"e" = (
/obj/structure/cliff/automatic,
/turf/simulated/mineral/floor/icey/snowbase/ignore_mapgen,
/area/submap/glacier/Excavation)
"f" = (
/obj/structure/cliff/automatic{
	dir = 5;
	icon_state = "cliffbuilder"
	},
/turf/simulated/mineral/floor/icey/snowbase/ignore_mapgen,
/area/submap/glacier/Excavation)
"g" = (
/obj/structure/cliff/automatic/corner{
	dir = 9;
	icon_state = "cliffbuilder-corner"
	},
/turf/simulated/mineral/floor/icey/snowbase/ignore_mapgen,
/area/submap/glacier/Excavation)
"h" = (
/obj/random/outcrop,
/turf/simulated/mineral/floor/icey/snowbase/ignore_mapgen,
/area/submap/glacier/Excavation)
"i" = (
/turf/simulated/mineral/floor/icey/snowbase/ignore_mapgen,
/area/submap/glacier/Excavation)
"j" = (
/obj/structure/cliff/automatic/corner,
/turf/simulated/mineral/floor/icey/snowbase/ignore_mapgen,
/area/submap/glacier/Excavation)
"k" = (
/obj/mecha/working/ripley,
/turf/simulated/mineral/floor/icey/snowbase/ignore_mapgen,
/area/submap/glacier/Excavation)
"l" = (
/obj/structure/cliff/automatic{
	dir = 8;
	icon_state = "cliffbuilder"
	},
/turf/simulated/mineral/floor/icey/snowbase/ignore_mapgen,
/area/submap/glacier/Excavation)
"m" = (
/obj/structure/table/sifwoodentable,
/obj/item/mecha_parts/mecha_equipment/tool/drill/bore,
/obj/item/weapon/ore/marble,
/turf/simulated/mineral/floor/icey/snowbase/ignore_mapgen,
/area/submap/glacier/Excavation)
"n" = (
/obj/item/weapon/ore,
/turf/simulated/mineral/floor/icey/snowbase/ignore_mapgen,
/area/submap/glacier/Excavation)
"o" = (
/obj/structure/table/sifwoodentable,
/obj/item/mecha_parts/mecha_equipment/hardpoint_actuator,
/turf/simulated/mineral/floor/icey/snowbase/ignore_mapgen,
/area/submap/glacier/Excavation)
"p" = (
/obj/structure/cliff/automatic{
	dir = 4;
	icon_state = "cliffbuilder"
	},
/turf/simulated/mineral/floor/icey/snowbase/ignore_mapgen,
/area/submap/glacier/Excavation)
"q" = (
/obj/structure/table/sifwoodentable,
/obj/item/mecha_parts/mecha_equipment/anticcw_armor_booster,
/turf/simulated/mineral/floor/icey/snowbase/ignore_mapgen,
/area/submap/glacier/Excavation)
"r" = (
/obj/structure/table/sifwoodentable,
/obj/item/mecha_parts/mecha_equipment/weapon/energy/laser/heavy/rigged,
/turf/simulated/mineral/floor/icey/snowbase/ignore_mapgen,
/area/submap/glacier/Excavation)
"s" = (
/obj/item/weapon/ore/marble,
/turf/simulated/mineral/floor/icey/snowbase/ignore_mapgen,
/area/submap/glacier/Excavation)
"t" = (
/obj/item/weapon/ore/gold,
/turf/simulated/mineral/floor/icey/snowbase/ignore_mapgen,
/area/submap/glacier/Excavation)
"u" = (
/obj/item/weapon/ore/diamond,
/turf/simulated/mineral/floor/icey/snowbase/ignore_mapgen,
/area/submap/glacier/Excavation)
"v" = (
/mob/living/simple_mob/mechanical/mining_drone,
/turf/simulated/mineral/floor/icey/snowbase/ignore_mapgen,
/area/submap/glacier/Excavation)
"w" = (
/obj/structure/table/sifwoodentable,
/obj/item/weapon/pickaxe/jackhammer,
/turf/simulated/mineral/floor/icey/snowbase/ignore_mapgen,
/area/submap/glacier/Excavation)
"x" = (
/obj/structure/table/sifwoodentable,
/obj/random/projectile/scrapped_grenadelauncher,
/turf/simulated/mineral/floor/icey/snowbase/ignore_mapgen,
/area/submap/glacier/Excavation)
"y" = (
/obj/structure/table/sifwoodentable,
/obj/random/medical/pillbottle,
/turf/simulated/mineral/floor/icey/snowbase/ignore_mapgen,
/area/submap/glacier/Excavation)
"z" = (
/obj/structure/table/sifwoodentable,
/obj/item/weapon/grenade/chem_grenade/metalfoam,
/obj/item/weapon/grenade/chem_grenade/metalfoam,
/obj/item/weapon/grenade/chem_grenade/metalfoam,
/turf/simulated/mineral/floor/icey/snowbase/ignore_mapgen,
/area/submap/glacier/Excavation)
"A" = (
/obj/structure/table/sifwoodentable,
/obj/item/weapon/mining_scanner,
/turf/simulated/mineral/floor/icey/snowbase/ignore_mapgen,
/area/submap/glacier/Excavation)
"B" = (
/obj/structure/table/sifwoodentable,
/obj/random/cigarettes,
/obj/random/tool/powermaint,
/turf/simulated/mineral/floor/icey/snowbase/ignore_mapgen,
/area/submap/glacier/Excavation)
"C" = (
/obj/structure/cliff/automatic{
	dir = 10;
	icon_state = "cliffbuilder"
	},
/turf/simulated/mineral/floor/icey/snowbase/ignore_mapgen,
/area/submap/glacier/Excavation)
"D" = (
/obj/structure/cliff/automatic{
	dir = 2;
	icon_state = "cliffbuilder"
	},
/turf/simulated/mineral/floor/icey/snowbase/ignore_mapgen,
/area/submap/glacier/Excavation)
"E" = (
/obj/structure/cliff/automatic/corner{
	dir = 10;
	icon_state = "cliffbuilder-corner"
	},
/turf/simulated/mineral/floor/icey/snowbase/ignore_mapgen,
/area/submap/glacier/Excavation)
"F" = (
/obj/structure/cliff/automatic/corner{
	dir = 6;
	icon_state = "cliffbuilder-corner"
	},
/turf/simulated/mineral/floor/icey/snowbase/ignore_mapgen,
/area/submap/glacier/Excavation)
"G" = (
/obj/structure/cliff/automatic{
	dir = 6;
	icon_state = "cliffbuilder"
	},
/turf/simulated/mineral/floor/icey/snowbase/ignore_mapgen,
/area/submap/glacier/Excavation)

(1,1,1) = {"
a
a
i
i
i
i
i
i
i
i
i
i
i
a
a
"}
(2,1,1) = {"
a
i
i
d
l
l
l
l
l
l
l
l
l
C
a
"}
(3,1,1) = {"
b
i
d
g
i
h
i
h
i
h
h
i
i
D
b
"}
(4,1,1) = {"
b
d
g
h
i
i
n
t
v
w
y
A
i
E
b
"}
(5,1,1) = {"
b
e
h
i
m
q
i
i
i
i
n
i
s
n
b
"}
(6,1,1) = {"
b
e
h
k
n
i
i
u
i
n
i
n
i
i
b
"}
(7,1,1) = {"
b
e
i
i
o
r
s
i
n
i
t
i
n
i
b
"}
(8,1,1) = {"
b
f
j
h
i
i
n
i
v
x
z
B
i
F
b
"}
(9,1,1) = {"
b
i
f
j
i
h
h
i
h
i
h
h
h
D
b
"}
(10,1,1) = {"
a
i
i
f
p
p
p
p
p
p
p
p
p
G
a
"}
(11,1,1) = {"
a
a
i
i
i
i
i
i
i
i
i
i
i
a
a
"}
