//MAP CONVERTED BY dmm2tgm.py THIS HEADER COMMENT PREVENTS RECONVERSION, DO NOT REMOVE
"a" = (
/turf/simulated/floor/airless/outdoors,
/area/submap/moonbase/poi/west_crater/construction2)
"f" = (
/obj/random/multiple/corp_crate,
/turf/simulated/floor/airless/outdoors,
/area/submap/moonbase/poi/west_crater/construction2)
"i" = (
/obj/structure/frame,
/turf/simulated/floor/airless/outdoors,
/area/submap/moonbase/poi/west_crater/construction2)
"k" = (
/turf/simulated/wall,
/area/submap/moonbase/poi/west_crater/construction2)
"l" = (
/obj/structure/table/steel,
/obj/random/maintenance,
/turf/simulated/floor/airless/moonbaseplating/outdoors{
	edge_blending_priority = 1
	},
/area/submap/moonbase/poi/west_crater/construction2)
"o" = (
/obj/structure/table/rack,
/obj/random/maintenance,
/obj/random/maintenance,
/turf/simulated/floor/airless/outdoors,
/area/submap/moonbase/poi/west_crater/construction2)
"w" = (
/obj/structure/table/steel,
/turf/simulated/floor/airless/moonbaseplating/outdoors{
	edge_blending_priority = 1
	},
/area/submap/moonbase/poi/west_crater/construction2)
"A" = (
/turf/simulated/floor/airless/moonbaseplating/outdoors{
	edge_blending_priority = 1
	},
/area/submap/moonbase/poi/west_crater/construction2)
"W" = (
/turf/simulated/mineral/floor/vacuum/moonbase/outdoors,
/area/submap/moonbase/poi/west_crater/construction2)
"X" = (
/obj/structure/girder,
/turf/simulated/floor/airless/outdoors,
/area/submap/moonbase/poi/west_crater/construction2)

(1,1,1) = {"
W
W
W
W
W
W
W
W
W
W
W
W
W
"}
(2,1,1) = {"
W
W
W
W
W
W
W
W
W
W
W
W
W
"}
(3,1,1) = {"
W
W
W
W
k
k
k
k
k
k
k
W
W
"}
(4,1,1) = {"
W
W
A
A
X
a
a
i
a
f
k
W
W
"}
(5,1,1) = {"
W
W
A
A
a
a
a
a
a
f
k
W
W
"}
(6,1,1) = {"
W
W
A
A
a
a
a
a
a
a
k
W
W
"}
(7,1,1) = {"
W
W
A
A
X
a
a
a
a
o
k
W
W
"}
(8,1,1) = {"
W
W
A
A
k
i
a
a
a
o
k
W
W
"}
(9,1,1) = {"
W
W
W
W
k
a
a
a
a
a
k
W
W
"}
(10,1,1) = {"
W
W
W
W
k
k
a
a
a
k
k
W
W
"}
(11,1,1) = {"
W
W
W
W
W
k
a
a
a
k
W
W
W
"}
(12,1,1) = {"
W
W
W
W
W
k
a
a
a
k
W
W
W
"}
(13,1,1) = {"
W
W
l
l
W
X
a
a
a
k
W
W
W
"}
(14,1,1) = {"
W
W
A
A
W
X
a
a
a
k
W
W
W
"}
(15,1,1) = {"
W
W
A
A
W
X
a
a
a
k
W
W
W
"}
(16,1,1) = {"
W
W
A
A
W
X
a
a
a
k
W
W
W
"}
(17,1,1) = {"
W
W
w
A
W
k
a
a
a
k
W
W
W
"}
(18,1,1) = {"
W
W
l
A
W
k
a
a
a
k
W
W
W
"}
(19,1,1) = {"
W
W
w
A
W
k
a
a
a
X
W
W
W
"}
(20,1,1) = {"
W
W
l
A
W
k
a
a
a
X
W
W
W
"}
(21,1,1) = {"
W
W
A
A
W
X
a
a
a
X
W
W
W
"}
(22,1,1) = {"
W
W
A
A
W
X
A
A
A
X
W
W
W
"}
(23,1,1) = {"
W
W
W
W
W
X
A
A
A
X
W
W
W
"}
(24,1,1) = {"
W
W
W
W
W
X
W
A
A
a
W
W
W
"}
(25,1,1) = {"
W
W
W
W
W
W
W
A
W
W
W
W
W
"}
(26,1,1) = {"
W
W
W
W
W
W
W
W
A
W
W
W
W
"}
(27,1,1) = {"
W
W
W
W
W
W
W
W
W
W
W
W
W
"}
(28,1,1) = {"
W
W
W
W
W
W
W
W
W
W
W
W
W
"}
