//MAP CONVERTED BY dmm2tgm.py THIS HEADER COMMENT PREVENTS RECONVERSION, DO NOT REMOVE
"a" = (
/turf/simulated/mineral/floor/vacuum/moonbase/outdoors,
/area/submap/moonbase/poi/west_crater/construction5)
"o" = (
/obj/random/multiple/corp_crate,
/turf/simulated/floor/plating/external/outdoors,
/area/submap/moonbase/poi/west_crater/construction5)
"q" = (
/turf/simulated/wall,
/area/submap/moonbase/poi/west_crater/construction5)
"y" = (
/turf/simulated/floor/plating/external/moonbaseplating/outdoors{
	edge_blending_priority = 1
	},
/area/submap/moonbase/poi/west_crater/construction5)
"E" = (
/obj/structure/table/steel,
/obj/random/maintenance,
/turf/simulated/floor/plating/external/outdoors,
/area/submap/moonbase/poi/west_crater/construction5)
"M" = (
/obj/structure/table/steel,
/turf/simulated/floor/plating/external/outdoors,
/area/submap/moonbase/poi/west_crater/construction5)
"N" = (
/obj/structure/table/rack,
/obj/random/maintenance,
/obj/random/maintenance,
/turf/simulated/floor/plating/external/outdoors,
/area/submap/moonbase/poi/west_crater/construction5)
"O" = (
/obj/structure/girder,
/turf/simulated/floor/plating/external/outdoors,
/area/submap/moonbase/poi/west_crater/construction5)
"V" = (
/obj/structure/frame,
/turf/simulated/floor/plating/external/outdoors,
/area/submap/moonbase/poi/west_crater/construction5)
"Z" = (
/turf/simulated/floor/plating/external/outdoors,
/area/submap/moonbase/poi/west_crater/construction5)

(1,1,1) = {"
a
a
a
a
a
a
a
a
a
a
a
a
a
a
a
a
a
a
a
a
a
a
a
a
"}
(2,1,1) = {"
a
a
a
a
a
a
a
a
a
a
a
a
a
a
a
a
a
a
a
a
a
a
a
a
"}
(3,1,1) = {"
a
a
q
q
O
O
q
q
q
a
a
a
a
a
a
y
a
a
a
a
a
a
a
a
"}
(4,1,1) = {"
a
a
q
N
N
o
Z
Z
q
a
a
a
a
a
a
a
y
a
a
a
a
a
a
a
"}
(5,1,1) = {"
a
a
q
Z
Z
Z
Z
Z
O
a
a
a
a
a
a
y
y
a
a
a
a
a
a
a
"}
(6,1,1) = {"
a
a
q
Z
Z
Z
Z
Z
O
a
a
a
a
a
a
y
y
a
a
a
a
a
a
a
"}
(7,1,1) = {"
a
a
q
Z
Z
Z
Z
Z
Z
y
y
y
y
y
y
y
y
y
y
y
y
y
a
a
"}
(8,1,1) = {"
a
a
O
Z
Z
Z
Z
Z
Z
y
y
y
y
y
y
y
y
y
y
y
a
a
a
a
"}
(9,1,1) = {"
a
a
O
Z
Z
Z
Z
Z
Z
a
a
a
a
a
a
y
y
a
a
a
a
a
a
a
"}
(10,1,1) = {"
a
a
O
V
Z
Z
Z
Z
O
a
a
a
a
a
a
y
y
a
a
a
a
a
a
a
"}
(11,1,1) = {"
a
a
O
Z
Z
Z
Z
Z
q
a
a
a
q
q
q
Z
Z
q
q
q
q
a
a
a
"}
(12,1,1) = {"
a
a
O
V
Z
Z
Z
Z
q
a
a
a
q
Z
Z
Z
Z
Z
Z
Z
q
a
a
a
"}
(13,1,1) = {"
a
a
O
O
O
q
q
q
q
a
a
a
O
Z
Z
Z
Z
Z
Z
o
q
a
a
a
"}
(14,1,1) = {"
a
a
a
a
a
a
a
a
a
a
a
a
O
Z
Z
Z
Z
Z
Z
Z
q
a
a
a
"}
(15,1,1) = {"
a
a
a
a
a
a
a
a
a
a
a
a
O
Z
Z
E
E
M
Z
Z
q
a
a
a
"}
(16,1,1) = {"
a
a
a
a
a
a
a
a
a
a
a
a
q
q
q
O
O
O
O
q
q
a
a
a
"}
(17,1,1) = {"
a
a
a
a
a
a
a
a
a
a
a
a
a
a
a
a
a
a
a
a
a
a
a
a
"}
(18,1,1) = {"
a
a
a
a
a
a
a
a
a
a
a
a
a
a
a
a
a
a
a
a
a
a
a
a
"}
