//MAP CONVERTED BY dmm2tgm.py THIS HEADER COMMENT PREVENTS RECONVERSION, DO NOT REMOVE
"a" = (
/turf/simulated/mineral/floor/vacuum/moonbase/outdoors,
/area/submap/moonbase/poi/west_crater/construction3)
"e" = (
/turf/simulated/floor/plating/external/outdoors,
/area/submap/moonbase/poi/west_crater/construction3)
"w" = (
/obj/structure/prop/rock/round,
/turf/simulated/mineral/floor/vacuum/moonbase/outdoors,
/area/submap/moonbase/poi/west_crater/construction3)
"y" = (
/obj/structure/prop/rock/crystal,
/turf/simulated/mineral/floor/vacuum/moonbase/outdoors,
/area/submap/moonbase/poi/west_crater/construction3)
"A" = (
/turf/simulated/wall,
/area/submap/moonbase/poi/west_crater/construction3)
"B" = (
/obj/structure/prop/rock/flat,
/turf/simulated/mineral/floor/vacuum/moonbase/outdoors,
/area/submap/moonbase/poi/west_crater/construction3)
"E" = (
/obj/structure/frame,
/turf/simulated/floor/plating/external/outdoors,
/area/submap/moonbase/poi/west_crater/construction3)
"I" = (
/obj/structure/girder,
/turf/simulated/floor/plating/external/outdoors,
/area/submap/moonbase/poi/west_crater/construction3)
"K" = (
/obj/structure/prop/rock/small,
/turf/simulated/mineral/floor/vacuum/moonbase/outdoors,
/area/submap/moonbase/poi/west_crater/construction3)
"V" = (
/obj/structure/table/steel,
/obj/random/maintenance,
/obj/random/maintenance,
/turf/simulated/floor/plating/external/outdoors,
/area/submap/moonbase/poi/west_crater/construction3)
"Y" = (
/obj/random/multiple/corp_crate,
/turf/simulated/floor/plating/external/outdoors,
/area/submap/moonbase/poi/west_crater/construction3)

(1,1,1) = {"
a
a
a
a
a
a
a
a
a
a
a
a
a
a
a
a
a
a
a
"}
(2,1,1) = {"
a
a
a
a
a
a
a
a
a
a
a
a
a
a
a
a
a
a
a
"}
(3,1,1) = {"
a
a
A
A
A
A
A
A
A
A
A
A
A
I
I
e
e
a
a
"}
(4,1,1) = {"
a
a
A
Y
e
e
e
e
e
e
e
e
e
e
e
e
e
a
a
"}
(5,1,1) = {"
a
a
I
V
e
e
e
e
e
e
e
e
e
e
e
e
I
a
a
"}
(6,1,1) = {"
a
a
I
V
e
I
I
I
I
I
e
e
e
e
e
e
A
a
a
"}
(7,1,1) = {"
a
a
I
e
e
I
a
a
a
a
a
a
a
I
e
e
A
a
a
"}
(8,1,1) = {"
a
a
e
e
e
I
a
a
a
B
a
a
a
I
e
E
A
a
a
"}
(9,1,1) = {"
a
a
e
e
e
I
a
y
a
a
a
a
a
I
e
e
A
a
a
"}
(10,1,1) = {"
a
a
e
e
e
e
a
a
a
a
K
a
a
I
e
e
A
a
a
"}
(11,1,1) = {"
a
a
e
e
e
e
a
a
a
a
a
a
a
I
e
E
A
a
a
"}
(12,1,1) = {"
a
a
I
e
e
e
a
a
w
a
a
y
a
I
e
e
A
a
a
"}
(13,1,1) = {"
a
a
A
e
e
e
a
a
a
a
a
a
a
e
e
e
A
a
a
"}
(14,1,1) = {"
a
a
A
e
e
I
I
I
I
e
e
e
e
e
e
e
e
a
a
"}
(15,1,1) = {"
a
a
A
e
e
e
e
e
e
e
e
e
e
e
e
e
e
a
a
"}
(16,1,1) = {"
a
a
A
E
e
e
e
e
e
e
e
e
Y
Y
e
e
A
a
a
"}
(17,1,1) = {"
a
a
A
A
A
A
A
A
A
A
A
A
A
A
A
A
A
a
a
"}
(18,1,1) = {"
a
a
a
a
a
a
a
a
a
a
a
a
a
a
a
a
a
a
a
"}
(19,1,1) = {"
a
a
a
a
a
a
a
a
a
a
a
a
a
a
a
a
a
a
a
"}
