//MAP CONVERTED BY dmm2tgm.py THIS HEADER COMMENT PREVENTS RECONVERSION, DO NOT REMOVE
"a" = (
/obj/structure/girder,
/turf/simulated/floor/airless/outdoors,
/area/submap/moonbase/poi/west_crater/construction1)
"c" = (
/obj/random/maintenance,
/obj/random/maintenance,
/obj/structure/table/steel,
/turf/simulated/floor/airless/outdoors,
/area/submap/moonbase/poi/west_crater/construction1)
"n" = (
/obj/random/multiple/corp_crate,
/turf/simulated/floor/airless/outdoors,
/area/submap/moonbase/poi/west_crater/construction1)
"p" = (
/turf/simulated/mineral/floor/vacuum/moonbase/outdoors,
/area/submap/moonbase/poi/west_crater/construction1)
"x" = (
/turf/simulated/wall,
/area/submap/moonbase/poi/west_crater/construction1)
"E" = (
/obj/structure/frame,
/turf/simulated/floor/airless/outdoors,
/area/submap/moonbase/poi/west_crater/construction1)
"O" = (
/turf/simulated/floor/airless/moonbaseplating/outdoors{
	edge_blending_priority = 1
	},
/area/submap/moonbase/poi/west_crater/construction1)
"U" = (
/turf/simulated/floor/airless/outdoors,
/area/submap/moonbase/poi/west_crater/construction1)

(1,1,1) = {"
p
p
p
p
p
p
p
p
p
p
p
p
p
p
p
p
p
"}
(2,1,1) = {"
p
p
p
p
p
p
p
p
p
p
p
p
p
p
p
p
p
"}
(3,1,1) = {"
p
p
a
a
U
x
x
x
x
x
x
x
x
x
x
p
p
"}
(4,1,1) = {"
p
p
a
U
U
U
U
x
n
E
U
U
c
c
x
p
p
"}
(5,1,1) = {"
p
p
U
U
U
U
U
U
U
U
U
U
U
U
x
p
p
"}
(6,1,1) = {"
p
p
a
E
U
U
U
x
U
U
U
U
U
U
x
p
p
"}
(7,1,1) = {"
p
p
x
U
U
U
U
x
x
a
U
U
a
x
x
p
p
"}
(8,1,1) = {"
p
p
x
E
U
U
U
x
p
p
O
O
O
p
p
p
p
"}
(9,1,1) = {"
p
p
x
U
U
U
U
a
O
p
O
p
O
p
p
p
p
"}
(10,1,1) = {"
p
p
x
U
U
U
U
U
O
p
O
O
O
p
p
p
p
"}
(11,1,1) = {"
p
p
x
n
U
U
U
U
O
p
p
O
O
p
p
p
p
"}
(12,1,1) = {"
p
p
x
n
U
U
U
a
O
p
O
p
O
p
p
p
p
"}
(13,1,1) = {"
p
p
x
x
x
x
x
a
p
p
p
p
p
p
p
p
p
"}
(14,1,1) = {"
p
p
p
p
p
p
p
p
p
p
p
p
p
p
p
p
p
"}
(15,1,1) = {"
p
p
p
p
p
p
p
p
p
p
p
p
p
p
p
p
p
"}
