//MAP CONVERTED BY dmm2tgm.py THIS HEADER COMMENT PREVENTS RECONVERSION, DO NOT REMOVE
"cs" = (
/obj/effect/floor_decal/milspec/color/green/half{
	dir = 4
	},
/obj/effect/floor_decal/steeldecal/steel_decals9{
	dir = 8
	},
/turf/simulated/floor/tiled,
/area/submap/moonbase/poi/west_crater/garden2)
"eu" = (
/obj/machinery/atmospherics/pipe/manifold/hidden/supply{
	dir = 1
	},
/turf/simulated/floor/tiled,
/area/submap/moonbase/poi/west_crater/garden2)
"fy" = (
/obj/structure/table/steel,
/obj/item/weapon/storage/toolbox/hydro,
/turf/simulated/floor/tiled/monotile,
/area/submap/moonbase/poi/west_crater/garden2)
"fU" = (
/obj/structure/table/steel,
/obj/machinery/recharger{
	pixel_y = 4
	},
/obj/random/powercell,
/obj/effect/floor_decal/milspec/color/green/half{
	dir = 8
	},
/obj/effect/floor_decal/steeldecal/steel_decals5{
	dir = 4
	},
/obj/machinery/atmospherics/pipe/simple/hidden/supply,
/turf/simulated/floor/tiled,
/area/submap/moonbase/poi/west_crater/garden2)
"gw" = (
/obj/machinery/light,
/turf/simulated/floor/water/indoors,
/area/submap/moonbase/poi/west_crater/garden2)
"if" = (
/obj/structure/table/steel,
/obj/item/bodybag/cryobag,
/obj/item/weapon/storage/firstaid/adv,
/obj/item/device/healthanalyzer,
/obj/machinery/atmospherics/unary/vent_pump/on{
	dir = 4
	},
/turf/simulated/floor/tiled/monotile,
/area/submap/moonbase/poi/west_crater/garden2)
"iK" = (
/obj/structure/cable,
/obj/machinery/power/apc/alarms_hidden{
	dir = 1
	},
/obj/structure/reagent_dispensers/watertank,
/turf/simulated/floor/outdoors/grass/forest{
	outdoors = 0
	},
/area/submap/moonbase/poi/west_crater/garden2)
"jb" = (
/obj/effect/floor_decal/milspec/color/green/half{
	dir = 4
	},
/turf/simulated/floor/tiled,
/area/submap/moonbase/poi/west_crater/garden2)
"jI" = (
/obj/effect/floor_decal/milspec/color/green/half{
	dir = 8
	},
/obj/effect/floor_decal/steeldecal/steel_decals9,
/turf/simulated/floor/tiled,
/area/submap/moonbase/poi/west_crater/garden2)
"ks" = (
/turf/simulated/floor/outdoors/grass/forest{
	outdoors = 0
	},
/area/submap/moonbase/poi/west_crater/garden2)
"mI" = (
/obj/effect/floor_decal/milspec/color/green/half{
	dir = 4
	},
/obj/effect/floor_decal/steeldecal/steel_decals9{
	dir = 1
	},
/turf/simulated/floor/tiled,
/area/submap/moonbase/poi/west_crater/garden2)
"mL" = (
/obj/machinery/vending/hydronutrients,
/turf/simulated/floor/tiled/monotile,
/area/submap/moonbase/poi/west_crater/garden2)
"os" = (
/obj/machinery/door/firedoor/glass,
/obj/structure/grille,
/obj/structure/window/reinforced/full,
/obj/structure/window/reinforced{
	dir = 8
	},
/obj/structure/window/reinforced,
/turf/simulated/floor/plating,
/area/submap/moonbase/poi/west_crater/garden2)
"oF" = (
/turf/simulated/floor/plating/external/moonbaseplating/outdoors{
	edge_blending_priority = 1
	},
/area/submap/moonbase/poi/west_crater/garden2)
"qm" = (
/turf/simulated/floor/tiled,
/area/submap/moonbase/poi/west_crater/garden2)
"qD" = (
/obj/structure/table/steel,
/obj/item/weapon/storage/belt/hydro,
/obj/machinery/atmospherics/unary/vent_pump/on{
	dir = 8
	},
/turf/simulated/floor/tiled/monotile,
/area/submap/moonbase/poi/west_crater/garden2)
"rn" = (
/obj/effect/floor_decal/milspec/color/green/half{
	dir = 10
	},
/obj/effect/floor_decal/steeldecal/steel_decals9{
	dir = 4
	},
/turf/simulated/floor/tiled,
/area/submap/moonbase/poi/west_crater/garden2)
"tf" = (
/obj/machinery/portable_atmospherics/hydroponics,
/turf/simulated/floor/outdoors/grass/forest{
	outdoors = 0
	},
/area/submap/moonbase/poi/west_crater/garden2)
"uN" = (
/obj/machinery/door/firedoor/glass,
/obj/machinery/door/airlock/glass_external,
/obj/effect/map_helper/airlock/door/ext_door,
/turf/simulated/floor/tiled/steel_ridged,
/area/submap/moonbase/poi/west_crater/garden2)
"ve" = (
/obj/machinery/power/rtg/fake_gen,
/obj/structure/cable{
	icon_state = "0-4"
	},
/turf/simulated/floor/plating/external/moonbaseplating/outdoors{
	edge_blending_priority = 1
	},
/area/submap/moonbase/poi/west_crater/garden2)
"yh" = (
/obj/machinery/atmospherics/pipe/simple/hidden/supply,
/turf/simulated/wall/r_wall,
/area/submap/moonbase/poi/west_crater/garden2)
"yo" = (
/obj/machinery/alarm,
/obj/structure/reagent_dispensers/watertank,
/turf/simulated/floor/outdoors/grass/forest{
	outdoors = 0
	},
/area/submap/moonbase/poi/west_crater/garden2)
"yB" = (
/obj/effect/floor_decal/milspec/color/green/half{
	dir = 8
	},
/turf/simulated/floor/tiled,
/area/submap/moonbase/poi/west_crater/garden2)
"zf" = (
/obj/machinery/atmospherics/pipe/simple/hidden{
	dir = 10
	},
/turf/simulated/wall/r_wall,
/area/submap/moonbase/poi/west_crater/garden2)
"zp" = (
/obj/structure/cable{
	icon_state = "2-8"
	},
/turf/simulated/floor/plating/external/moonbaseplating/outdoors{
	edge_blending_priority = 1
	},
/area/submap/moonbase/poi/west_crater/garden2)
"Am" = (
/obj/effect/floor_decal/milspec/color/green/half,
/turf/simulated/floor/tiled,
/area/submap/moonbase/poi/west_crater/garden2)
"Ax" = (
/obj/machinery/atmospherics/pipe/simple/hidden,
/turf/simulated/wall/r_wall,
/area/submap/moonbase/poi/west_crater/garden2)
"AM" = (
/obj/machinery/door/firedoor/glass,
/obj/structure/grille,
/obj/structure/window/reinforced/full,
/obj/structure/window/reinforced,
/obj/structure/window/reinforced{
	dir = 1
	},
/turf/simulated/floor/plating,
/area/submap/moonbase/poi/west_crater/garden2)
"BJ" = (
/obj/machinery/door/firedoor/glass,
/obj/structure/grille,
/obj/structure/window/reinforced/full,
/obj/structure/window/reinforced{
	dir = 8
	},
/obj/structure/window/reinforced{
	dir = 4
	},
/turf/simulated/floor/plating,
/area/submap/moonbase/poi/west_crater/garden2)
"BU" = (
/turf/template_noop,
/area/template_noop)
"Ca" = (
/obj/machinery/atmospherics/pipe/simple/hidden/supply,
/turf/simulated/floor/tiled,
/area/submap/moonbase/poi/west_crater/garden2)
"Ej" = (
/obj/machinery/biogenerator,
/turf/simulated/floor/tiled/monotile,
/area/submap/moonbase/poi/west_crater/garden2)
"EF" = (
/obj/machinery/atmospherics/pipe/simple/hidden/supply{
	dir = 10
	},
/obj/machinery/meter,
/turf/simulated/floor/plating/external/moonbaseplating/outdoors{
	edge_blending_priority = 1
	},
/area/submap/moonbase/poi/west_crater/garden2)
"Ha" = (
/obj/structure/closet,
/obj/item/clothing/suit/space/void/refurb,
/obj/item/clothing/suit/space/void/refurb,
/obj/item/clothing/head/helmet/space/void/refurb,
/obj/item/clothing/head/helmet/space/void/refurb,
/obj/item/clothing/mask/breath,
/obj/item/clothing/mask/breath,
/obj/item/weapon/tank/oxygen,
/obj/item/weapon/tank/oxygen,
/obj/machinery/atmospherics/pipe/simple/hidden/universal,
/turf/simulated/floor/tiled/monotile,
/area/submap/moonbase/poi/west_crater/garden2)
"Ic" = (
/obj/effect/floor_decal/milspec/color/green/half{
	dir = 4
	},
/obj/effect/floor_decal/steeldecal/steel_decals5{
	dir = 8
	},
/obj/machinery/portable_atmospherics/canister/oxygen,
/turf/simulated/floor/tiled,
/area/submap/moonbase/poi/west_crater/garden2)
"Ij" = (
/obj/effect/floor_decal/steeldecal/steel_decals5{
	dir = 1
	},
/obj/effect/floor_decal/steeldecal/steel_decals5,
/obj/effect/floor_decal/industrial/loading/white,
/obj/effect/map_helper/airlock/sensor/int_sensor,
/obj/machinery/airlock_sensor/airlock_interior{
	pixel_x = 32;
	pixel_y = 24
	},
/turf/simulated/floor/tiled,
/area/submap/moonbase/poi/west_crater/garden2)
"Io" = (
/turf/simulated/mineral/floor/vacuum/moonbase/outdoors,
/area/submap/moonbase/poi/west_crater/garden2)
"Kk" = (
/obj/machinery/atmospherics/unary/vent_pump/high_volume{
	dir = 4
	},
/obj/machinery/airlock_sensor{
	dir = 8;
	pixel_x = 24
	},
/obj/effect/map_helper/airlock/sensor/chamber_sensor,
/obj/effect/map_helper/airlock/atmos/chamber_pump,
/obj/machinery/embedded_controller/radio/airlock/airlock_controller{
	dir = 4;
	pixel_x = -24;
	id_tag = "garden2_airlock"
	},
/obj/machinery/light/small{
	dir = 4
	},
/turf/simulated/floor/tiled/eris/dark/gray_platform,
/area/submap/moonbase/poi/west_crater/garden2)
"Lj" = (
/obj/structure/table/steel,
/obj/random/mre,
/obj/random/mre,
/obj/machinery/atmospherics/pipe/manifold/hidden/supply,
/turf/simulated/floor/tiled/monotile,
/area/submap/moonbase/poi/west_crater/garden2)
"Lt" = (
/obj/machinery/atmospherics/pipe/simple/hidden/supply{
	dir = 4
	},
/turf/simulated/floor/tiled,
/area/submap/moonbase/poi/west_crater/garden2)
"Lx" = (
/obj/effect/floor_decal/milspec/color/green/half{
	dir = 8
	},
/obj/effect/floor_decal/steeldecal/steel_decals9{
	dir = 4
	},
/obj/machinery/atmospherics/pipe/simple/hidden/supply{
	dir = 5
	},
/turf/simulated/floor/tiled,
/area/submap/moonbase/poi/west_crater/garden2)
"Mo" = (
/obj/machinery/atmospherics/pipe/tank/air{
	dir = 4
	},
/turf/simulated/floor/plating/external/moonbaseplating/outdoors{
	edge_blending_priority = 1
	},
/area/submap/moonbase/poi/west_crater/garden2)
"Ni" = (
/obj/machinery/portable_atmospherics/hydroponics,
/obj/machinery/light{
	dir = 4
	},
/turf/simulated/floor/outdoors/grass/forest{
	outdoors = 0
	},
/area/submap/moonbase/poi/west_crater/garden2)
"Ox" = (
/obj/machinery/seed_storage/garden,
/turf/simulated/floor/tiled/monotile,
/area/submap/moonbase/poi/west_crater/garden2)
"PG" = (
/obj/structure/cable{
	icon_state = "1-2"
	},
/turf/simulated/wall/r_wall,
/area/submap/moonbase/poi/west_crater/garden2)
"PW" = (
/obj/effect/map_helper/airlock/sensor/ext_sensor,
/obj/machinery/airlock_sensor/airlock_exterior{
	dir = 1;
	pixel_y = -24;
	pixel_x = -32
	},
/turf/simulated/floor/plating/external/moonbaseplating/outdoors{
	edge_blending_priority = 1
	},
/area/submap/moonbase/poi/west_crater/garden2)
"Sc" = (
/obj/effect/floor_decal/milspec/color/green/half{
	dir = 6
	},
/obj/effect/floor_decal/steeldecal/steel_decals9{
	dir = 1
	},
/turf/simulated/floor/tiled,
/area/submap/moonbase/poi/west_crater/garden2)
"So" = (
/obj/structure/railing/grey{
	dir = 1
	},
/turf/simulated/floor/water/indoors,
/area/submap/moonbase/poi/west_crater/garden2)
"SQ" = (
/obj/machinery/door/firedoor/glass,
/obj/structure/grille,
/obj/structure/window/reinforced/full,
/obj/structure/window/reinforced{
	dir = 4
	},
/obj/structure/window/reinforced,
/turf/simulated/floor/plating,
/area/submap/moonbase/poi/west_crater/garden2)
"Uf" = (
/obj/structure/table/steel,
/obj/machinery/cell_charger{
	pixel_x = 0;
	pixel_y = 4
	},
/obj/random/powercell,
/obj/machinery/light{
	dir = 1
	},
/turf/simulated/floor/tiled/monotile,
/area/submap/moonbase/poi/west_crater/garden2)
"VC" = (
/obj/machinery/portable_atmospherics/hydroponics,
/obj/machinery/light{
	dir = 8
	},
/turf/simulated/floor/outdoors/grass/forest{
	outdoors = 0
	},
/area/submap/moonbase/poi/west_crater/garden2)
"Wl" = (
/obj/machinery/atmospherics/pipe/simple/hidden/supply,
/obj/item/device/gps/internal/poi{
	gps_tag = "Unidentified Signal"
	},
/turf/simulated/floor/tiled,
/area/submap/moonbase/poi/west_crater/garden2)
"XP" = (
/obj/machinery/atmospherics/pipe/simple/hidden/universal{
	dir = 4
	},
/turf/simulated/floor/plating/external/moonbaseplating/outdoors{
	edge_blending_priority = 1
	},
/area/submap/moonbase/poi/west_crater/garden2)
"Zp" = (
/obj/machinery/door/firedoor/glass,
/obj/machinery/door/airlock/glass_external,
/obj/effect/map_helper/airlock/door/int_door,
/turf/simulated/floor/tiled/steel_ridged,
/area/submap/moonbase/poi/west_crater/garden2)
"ZH" = (
/turf/simulated/wall/r_wall,
/area/submap/moonbase/poi/west_crater/garden2)
"ZW" = (
/turf/simulated/floor/water/indoors,
/area/submap/moonbase/poi/west_crater/garden2)
"ZY" = (
/obj/machinery/atmospherics/pipe/simple/hidden/supply{
	dir = 9
	},
/turf/simulated/floor/tiled,
/area/submap/moonbase/poi/west_crater/garden2)

(1,1,1) = {"
BU
BU
BU
BU
Io
Io
Io
Io
Io
Io
Io
Io
Io
Io
Io
Io
Io
BU
"}
(2,1,1) = {"
BU
BU
BU
Io
Io
Io
Io
Io
Io
Io
Io
Io
Io
Io
Io
Io
Io
Io
"}
(3,1,1) = {"
BU
BU
BU
Io
Io
ZH
BJ
BJ
BJ
BJ
BJ
BJ
BJ
BJ
BJ
os
Io
Io
"}
(4,1,1) = {"
BU
BU
BU
Io
Mo
ZH
tf
ks
VC
ks
tf
ks
VC
ks
tf
AM
Io
Io
"}
(5,1,1) = {"
BU
BU
Io
Io
XP
ZH
yo
ks
ks
ks
ks
ks
ks
ks
ks
AM
Io
Io
"}
(6,1,1) = {"
BU
Io
Io
Io
EF
yh
fU
Lx
yB
jI
yB
yB
rn
ks
ZW
AM
Io
Io
"}
(7,1,1) = {"
Io
Io
Io
ZH
ZH
ZH
Uf
Lt
mL
qm
Ej
if
Am
So
ZW
AM
Io
Io
"}
(8,1,1) = {"
Io
Io
PW
uN
Kk
Zp
Ij
eu
Ca
Wl
Ca
Lj
Am
So
gw
AM
Io
Io
"}
(9,1,1) = {"
Io
Io
Io
ZH
zf
Ax
Ha
ZY
Ox
qm
fy
qD
Am
So
ZW
AM
Io
Io
"}
(10,1,1) = {"
BU
Io
Io
Io
ve
ZH
Ic
mI
jb
cs
jb
jb
Sc
ks
ZW
AM
Io
Io
"}
(11,1,1) = {"
BU
BU
Io
Io
zp
PG
iK
ks
ks
ks
ks
ks
ks
ks
ks
AM
Io
Io
"}
(12,1,1) = {"
BU
BU
BU
Io
oF
ZH
tf
ks
Ni
ks
tf
ks
Ni
ks
tf
AM
Io
Io
"}
(13,1,1) = {"
BU
BU
BU
Io
Io
ZH
BJ
BJ
BJ
BJ
BJ
BJ
BJ
BJ
BJ
SQ
Io
Io
"}
(14,1,1) = {"
BU
BU
BU
Io
Io
Io
Io
Io
Io
Io
Io
Io
Io
Io
Io
Io
Io
Io
"}
(15,1,1) = {"
BU
BU
BU
BU
Io
Io
Io
Io
Io
Io
Io
Io
Io
Io
Io
Io
Io
BU
"}
