//MAP CONVERTED BY dmm2tgm.py THIS HEADER COMMENT PREVENTS RECONVERSION, DO NOT REMOVE
"a" = (
/turf/simulated/mineral/floor/vacuum/moonbase/outdoors,
/area/submap/moonbase/poi/west_crater/rocks4)
"b" = (
/obj/structure/prop/rock/crystal_dust,
/turf/simulated/mineral/floor/vacuum/moonbase/outdoors,
/area/submap/moonbase/poi/west_crater/rocks4)
"l" = (
/turf/simulated/mineral/moonbase/ignore_mapgen,
/area/submap/moonbase/poi/west_crater/rocks4)
"U" = (
/obj/structure/prop/rock/crystal,
/turf/simulated/mineral/floor/vacuum/moonbase/outdoors,
/area/submap/moonbase/poi/west_crater/rocks4)

(1,1,1) = {"
a
a
a
a
a
a
a
a
a
a
a
a
a
"}
(2,1,1) = {"
a
l
l
l
a
a
a
a
a
a
l
l
a
"}
(3,1,1) = {"
a
l
l
l
l
a
a
a
a
l
l
a
a
"}
(4,1,1) = {"
a
a
a
a
a
a
a
l
l
l
a
a
a
"}
(5,1,1) = {"
a
a
a
a
a
a
a
l
l
a
a
U
a
"}
(6,1,1) = {"
a
a
b
l
l
a
a
a
a
a
a
a
a
"}
(7,1,1) = {"
a
a
a
l
l
l
a
a
a
a
a
a
a
"}
(8,1,1) = {"
a
a
a
a
l
l
l
l
a
a
a
a
a
"}
(9,1,1) = {"
a
a
a
a
a
l
l
l
l
l
a
a
a
"}
(10,1,1) = {"
a
a
a
U
a
a
a
l
l
l
l
a
a
"}
(11,1,1) = {"
a
a
a
a
a
a
a
a
a
l
l
a
a
"}
(12,1,1) = {"
a
a
a
a
a
a
a
a
a
a
a
a
a
"}
