//MAP CONVERTED BY dmm2tgm.py THIS HEADER COMMENT PREVENTS RECONVERSION, DO NOT REMOVE
"a" = (
/turf/simulated/mineral/floor/vacuum/moonbase/outdoors,
/area/submap/moonbase/poi/west_crater/rocks2)
"G" = (
/turf/simulated/mineral/moonbase/ignore_mapgen,
/area/submap/moonbase/poi/west_crater/rocks2)
"R" = (
/obj/structure/prop/rock/crystal_dust,
/turf/simulated/mineral/floor/vacuum/moonbase/outdoors,
/area/submap/moonbase/poi/west_crater/rocks2)
"S" = (
/obj/structure/prop/rock/crystal,
/turf/simulated/mineral/floor/vacuum/moonbase/outdoors,
/area/submap/moonbase/poi/west_crater/rocks2)

(1,1,1) = {"
a
a
a
a
a
a
a
a
a
a
a
a
a
a
a
"}
(2,1,1) = {"
a
a
a
G
a
a
a
S
a
a
G
G
G
a
a
"}
(3,1,1) = {"
a
a
G
G
a
a
a
a
a
a
G
G
G
G
a
"}
(4,1,1) = {"
a
G
G
a
a
a
a
a
a
a
a
G
G
G
a
"}
(5,1,1) = {"
a
G
a
a
a
G
G
G
a
a
a
a
G
G
a
"}
(6,1,1) = {"
a
G
a
a
R
G
G
G
G
G
a
a
a
G
a
"}
(7,1,1) = {"
a
a
a
a
G
G
G
G
G
G
a
a
a
a
a
"}
(8,1,1) = {"
a
a
a
a
G
G
G
G
G
G
a
a
a
S
a
"}
(9,1,1) = {"
a
S
a
a
G
G
G
G
G
R
a
a
a
a
a
"}
(10,1,1) = {"
a
a
a
a
G
G
G
a
a
a
a
a
G
G
a
"}
(11,1,1) = {"
a
a
a
a
a
a
a
a
a
a
a
a
G
a
a
"}
(12,1,1) = {"
a
G
G
a
a
a
a
a
a
a
a
G
G
a
a
"}
(13,1,1) = {"
a
G
G
G
G
G
G
G
R
a
a
G
G
a
a
"}
(14,1,1) = {"
a
a
G
G
G
G
G
a
a
a
a
a
a
a
a
"}
(15,1,1) = {"
a
a
a
a
a
a
a
a
a
a
a
a
a
a
a
"}
