//MAP CONVERTED BY dmm2tgm.py THIS HEADER COMMENT PREVENTS RECONVERSION, DO NOT REMOVE
"a" = (
/turf/simulated/mineral/floor/vacuum/moonbase/outdoors,
/area/submap/moonbase/poi/west_crater/rocks6)
"h" = (
/obj/structure/prop/rock/crystal,
/turf/simulated/mineral/floor/vacuum/moonbase/outdoors,
/area/submap/moonbase/poi/west_crater/rocks6)
"v" = (
/turf/simulated/mineral/moonbase/ignore_mapgen,
/area/submap/moonbase/poi/west_crater/rocks6)
"R" = (
/obj/structure/outcrop/diamond,
/turf/simulated/mineral/floor/vacuum/moonbase/outdoors,
/area/submap/moonbase/poi/west_crater/rocks6)

(1,1,1) = {"
a
a
a
a
a
a
a
a
a
a
a
a
a
"}
(2,1,1) = {"
a
a
a
a
a
v
v
v
v
a
a
a
a
"}
(3,1,1) = {"
a
a
a
v
v
v
v
v
v
v
a
a
a
"}
(4,1,1) = {"
a
a
v
v
v
v
v
v
v
v
v
a
a
"}
(5,1,1) = {"
a
a
v
v
v
a
a
a
a
v
v
v
a
"}
(6,1,1) = {"
a
a
v
v
a
a
a
a
a
v
v
v
a
"}
(7,1,1) = {"
a
v
v
v
h
a
v
v
a
a
v
v
a
"}
(8,1,1) = {"
a
v
v
v
a
a
R
v
v
a
v
v
a
"}
(9,1,1) = {"
a
v
v
v
a
R
v
v
v
a
v
v
a
"}
(10,1,1) = {"
a
a
v
v
v
v
v
v
v
a
v
v
a
"}
(11,1,1) = {"
a
a
v
v
v
v
v
v
a
a
v
v
a
"}
(12,1,1) = {"
a
a
a
v
v
a
a
a
a
v
v
v
a
"}
(13,1,1) = {"
a
a
a
a
a
a
v
v
v
v
v
a
a
"}
(14,1,1) = {"
a
a
a
a
a
v
v
v
v
v
a
a
a
"}
(15,1,1) = {"
a
a
a
a
a
a
a
a
a
a
a
a
a
"}
