//MAP CONVERTED BY dmm2tgm.py THIS HEADER COMMENT PREVENTS RECONVERSION, DO NOT REMOVE
"a" = (
/turf/simulated/mineral/floor/vacuum/moonbase/outdoors,
/area/submap/moonbase/poi/west_crater/rocks3)
"f" = (
/turf/simulated/mineral/moonbase/ignore_mapgen,
/area/submap/moonbase/poi/west_crater/rocks3)
"s" = (
/obj/structure/prop/rock/crystal,
/turf/simulated/mineral/floor/vacuum/moonbase/outdoors,
/area/submap/moonbase/poi/west_crater/rocks3)
"O" = (
/obj/structure/prop/rock/crystal_dust,
/turf/simulated/mineral/floor/vacuum/moonbase/outdoors,
/area/submap/moonbase/poi/west_crater/rocks3)

(1,1,1) = {"
a
a
a
a
a
a
a
a
a
a
a
"}
(2,1,1) = {"
a
a
a
f
f
a
a
a
a
a
a
"}
(3,1,1) = {"
a
a
f
f
a
a
a
a
a
a
a
"}
(4,1,1) = {"
a
f
f
s
a
a
a
a
O
f
a
"}
(5,1,1) = {"
a
f
f
a
a
a
a
a
f
f
a
"}
(6,1,1) = {"
a
f
a
a
a
a
a
s
f
f
a
"}
(7,1,1) = {"
a
a
a
a
a
a
a
f
f
f
a
"}
(8,1,1) = {"
a
a
a
a
a
a
f
f
f
a
a
"}
(9,1,1) = {"
a
a
a
O
f
f
f
f
f
a
a
"}
(10,1,1) = {"
a
a
a
f
f
f
f
a
a
a
a
"}
(11,1,1) = {"
a
a
a
a
a
a
a
a
a
a
a
"}
