//MAP CONVERTED BY dmm2tgm.py THIS HEADER COMMENT PREVENTS RECONVERSION, DO NOT REMOVE
"a" = (
/turf/simulated/mineral/moonbase/ignore_mapgen,
/area/submap/moonbase/poi/west_crater/rocks5)
"c" = (
/turf/simulated/mineral/floor/vacuum/moonbase,
/area/submap/moonbase/poi/west_crater/rocks5)
"e" = (
/obj/structure/outcrop/platinum,
/turf/simulated/mineral/floor/vacuum/moonbase,
/area/submap/moonbase/poi/west_crater/rocks5)
"B" = (
/obj/structure/outcrop/diamond,
/turf/simulated/mineral/floor/vacuum/moonbase,
/area/submap/moonbase/poi/west_crater/rocks5)
"Y" = (
/turf/simulated/mineral/floor/vacuum/moonbase/outdoors,
/area/submap/moonbase/poi/west_crater/rocks5)

(1,1,1) = {"
Y
Y
Y
Y
Y
Y
Y
Y
Y
Y
Y
Y
"}
(2,1,1) = {"
Y
Y
a
a
a
a
a
Y
Y
Y
Y
Y
"}
(3,1,1) = {"
Y
a
a
a
a
a
a
a
a
a
Y
Y
"}
(4,1,1) = {"
Y
a
a
a
c
c
a
a
a
a
Y
Y
"}
(5,1,1) = {"
Y
Y
c
c
c
c
c
a
a
a
a
Y
"}
(6,1,1) = {"
Y
Y
c
c
c
e
c
c
c
a
a
Y
"}
(7,1,1) = {"
Y
Y
c
c
c
c
c
c
a
a
a
Y
"}
(8,1,1) = {"
Y
Y
c
c
c
c
B
c
a
a
Y
Y
"}
(9,1,1) = {"
Y
Y
c
e
c
c
c
c
a
a
Y
Y
"}
(10,1,1) = {"
Y
Y
c
c
c
c
c
a
a
a
Y
Y
"}
(11,1,1) = {"
Y
a
a
a
c
c
a
a
a
Y
Y
Y
"}
(12,1,1) = {"
Y
a
a
a
a
a
a
a
a
Y
Y
Y
"}
(13,1,1) = {"
Y
Y
Y
a
a
a
a
Y
Y
Y
Y
Y
"}
(14,1,1) = {"
Y
Y
Y
Y
Y
Y
Y
Y
Y
Y
Y
Y
"}
