//MAP CONVERTED BY dmm2tgm.py THIS HEADER COMMENT PREVENTS RECONVERSION, DO NOT REMOVE
"a" = (
/turf/template_noop,
/area/template_noop)
"k" = (
/obj/structure/outcrop/platinum,
/turf/simulated/mineral/floor/vacuum/moonbase/outdoors,
/area/submap/moonbase/poi/west_crater/rocks1)
"z" = (
/obj/machinery/crystal,
/turf/simulated/mineral/floor/vacuum/moonbase/outdoors,
/area/submap/moonbase/poi/west_crater/rocks1)
"H" = (
/obj/machinery/crystal/ice,
/turf/simulated/mineral/floor/vacuum/moonbase/outdoors,
/area/submap/moonbase/poi/west_crater/rocks1)
"I" = (
/turf/simulated/mineral/floor/vacuum/moonbase/outdoors,
/area/submap/moonbase/poi/west_crater/rocks1)
"O" = (
/obj/machinery/crystal/lava,
/turf/simulated/mineral/floor/vacuum/moonbase/outdoors,
/area/submap/moonbase/poi/west_crater/rocks1)
"T" = (
/obj/structure/prop/rock/crystal,
/turf/simulated/mineral/floor/vacuum/moonbase/outdoors,
/area/submap/moonbase/poi/west_crater/rocks1)
"X" = (
/turf/simulated/mineral/moonbase/ignore_mapgen,
/area/submap/moonbase/poi/west_crater/rocks1)

(1,1,1) = {"
a
a
a
I
I
I
I
I
I
I
I
a
a
a
"}
(2,1,1) = {"
a
a
a
I
z
I
I
I
I
I
I
I
a
a
"}
(3,1,1) = {"
a
a
I
I
I
I
X
X
X
X
I
I
I
a
"}
(4,1,1) = {"
a
a
I
I
I
I
I
I
X
X
X
I
I
I
"}
(5,1,1) = {"
a
a
I
I
I
I
I
I
I
I
I
I
I
I
"}
(6,1,1) = {"
a
I
I
I
I
I
I
k
I
I
I
I
I
I
"}
(7,1,1) = {"
a
I
I
I
k
I
I
I
I
I
X
I
I
I
"}
(8,1,1) = {"
a
I
I
I
I
I
T
I
I
I
X
I
I
I
"}
(9,1,1) = {"
I
I
I
X
I
I
I
I
I
X
X
I
O
I
"}
(10,1,1) = {"
I
I
X
X
X
I
I
I
I
X
X
I
I
I
"}
(11,1,1) = {"
I
I
I
X
X
I
k
I
I
X
X
I
I
I
"}
(12,1,1) = {"
I
I
I
I
I
I
I
I
I
X
I
I
I
I
"}
(13,1,1) = {"
a
I
I
I
I
I
I
I
I
I
I
I
I
I
"}
(14,1,1) = {"
a
a
I
I
I
H
I
I
I
I
I
I
I
a
"}
(15,1,1) = {"
a
a
a
I
I
I
I
I
I
I
I
I
a
a
"}
