//MAP CONVERTED BY dmm2tgm.py THIS HEADER COMMENT PREVENTS RECONVERSION, DO NOT REMOVE
"a" = (
/turf/simulated/mineral/floor/vacuum/moonbase/outdoors,
/area/submap/moonbase/poi/west_crater/rocks6)
"j" = (
/obj/structure/prop/rock/crystal,
/turf/simulated/mineral/floor/vacuum/moonbase/outdoors,
/area/submap/moonbase/poi/west_crater/rocks6)
"z" = (
/turf/simulated/mineral/moonbase/ignore_mapgen,
/area/submap/moonbase/poi/west_crater/rocks6)
"O" = (
/obj/structure/prop/rock/crystal_dust,
/turf/simulated/mineral/floor/vacuum/moonbase/outdoors,
/area/submap/moonbase/poi/west_crater/rocks6)

(1,1,1) = {"
a
a
a
a
a
a
a
a
a
"}
(2,1,1) = {"
a
a
a
a
O
a
a
a
a
"}
(3,1,1) = {"
a
j
a
a
a
a
a
a
a
"}
(4,1,1) = {"
a
a
a
a
a
a
a
j
a
"}
(5,1,1) = {"
a
a
a
a
a
a
a
a
a
"}
(6,1,1) = {"
a
a
a
z
z
a
a
a
a
"}
(7,1,1) = {"
a
a
z
z
z
a
a
a
a
"}
(8,1,1) = {"
a
a
z
z
z
z
a
a
a
"}
(9,1,1) = {"
a
a
a
z
z
a
a
a
a
"}
(10,1,1) = {"
a
a
a
a
a
a
a
a
a
"}
(11,1,1) = {"
a
a
a
a
a
a
a
O
a
"}
(12,1,1) = {"
a
O
a
a
a
a
a
a
a
"}
(13,1,1) = {"
a
a
a
a
j
a
a
a
a
"}
(14,1,1) = {"
a
a
a
a
a
a
a
a
a
"}
